,Repository,h1,h2,N1,N2,vocabulary,length,calculated_length,volume,difficulty,effort,time,bugs
0,VoxFormer,11,34,24,47,45,71,211.02748440752185,389.9215698394069,7.602941176470588,2964.5507589260787,164.69726438478216,0.12997385661313562
1,VoxFormer,10,51,32,63,61,95,322.5129733894199,563.4200470684742,6.176470588235294,3479.9473495405764,193.3304083078098,0.18780668235615808
2,VoxFormer,0,0,0,0,0,0,0,0,0,0,0.0,0.0
3,VoxFormer,0,0,0,0,0,0,0,0,0,0,0.0,0.0
4,VoxFormer,0,0,0,0,0,0,0,0,0,0,0.0,0.0
5,VoxFormer,0,0,0,0,0,0,0,0,0,0,0.0,0.0
6,VoxFormer,9,64,55,98,73,153,412.5293250129808,947.0431575086427,6.890625,6525.719257207991,362.53995873377727,0.3156810525028809
7,VoxFormer,0,0,0,0,0,0,0,0,0,0,0.0,0.0
8,VoxFormer,4,8,6,12,12,18,32.0,64.52932501298082,3.0,193.58797503894246,10.75488750216347,0.02150977500432694
9,VoxFormer,1,4,2,4,5,6,8.0,13.931568569324174,0.5,6.965784284662087,0.3869880158145604,0.004643856189774725
10,VoxFormer,7,18,13,26,25,39,94.71013448036484,181.11039140121426,5.055555555555555,915.6136454172498,50.867424745402765,0.06037013046707142
11,VoxFormer,8,13,10,17,21,27,72.10571633583419,118.59257041502654,5.230769230769231,620.3303683247542,34.46279824026412,0.03953085680500885
12,VoxFormer,0,0,0,0,0,0,0,0,0,0,0.0,0.0
13,VoxFormer,13,105,90,172,118,262,753.1014956907771,1803.2524789328024,10.647619047619047,19200.345442351172,1066.6858579083985,0.6010841596442674
14,VoxFormer,1,1,1,1,2,2,0.0,2.0,0.5,1.0,0.05555555555555555,0.0006666666666666666
15,VoxFormer,0,0,0,0,0,0,0,0,0,0,0.0,0.0
16,VoxFormer,6,60,43,86,66,129,369.92321074083804,779.7268413972405,4.3,3352.825418008134,186.26807877822966,0.25990894713241347
17,VoxFormer,0,0,0,0,0,0,0,0,0,0,0.0,0.0
18,VoxFormer,0,0,0,0,0,0,0,0,0,0,0.0,0.0
19,VoxFormer,0,0,0,0,0,0,0,0,0,0,0.0,0.0
20,VoxFormer,7,16,13,24,23,37,83.65148445440323,167.37179237410948,5.25,878.7019099640747,48.81677277578193,0.055790597458036495
21,VoxFormer,9,79,87,173,88,260,526.5280041189719,1679.4522208456976,9.854430379746836,16550.044986435136,919.4469436908408,0.5598174069485659
22,VoxFormer,16,73,65,115,89,180,515.8571927982413,1165.6320175739515,12.602739726027398,14690.156933808705,816.1198296560392,0.3885440058579838
23,VoxFormer,0,0,0,0,0,0,0,0,0,0,0.0,0.0
24,VoxFormer,0,0,0,0,0,0,0,0,0,0,0.0,0.0
25,VoxFormer,17,73,68,119,90,187,521.344061099497,1213.9765290136493,13.856164383561644,16821.058343798715,934.5032413221509,0.40465884300454974
26,VoxFormer,11,71,55,101,82,156,474.6857932898427,991.7781127204212,7.823943661971831,7759.6160791013235,431.08978217229577,0.33059270424014037
27,VoxFormer,6,37,23,46,43,69,208.2595495325981,374.41226807444474,3.72972972972973,1396.456567412794,77.58092041182188,0.12480408935814824
28,VoxFormer,4,9,6,11,13,17,36.52932501298081,62.907475208398566,2.4444444444444446,153.7738282871965,8.542990460399805,0.02096915840279952
29,VoxFormer,7,12,7,13,19,20,62.67103446305711,84.9585502688717,3.7916666666666665,322.1345031028052,17.896361283489178,0.028319516756290568
30,VoxFormer,0,0,0,0,0,0,0,0,0,0,0.0,0.0
31,VoxFormer,15,112,73,140,127,213,821.0271102045793,1488.5898382824714,9.375,13955.529733898169,775.3072074387871,0.49619661276082383
32,VoxFormer,0,0,0,0,0,0,0,0,0,0,0.0,0.0
33,VoxFormer,5,23,13,26,28,39,115.65156546374811,187.48684196024655,2.8260869565217392,529.8541185833055,29.436339921294753,0.06249561398674885
34,VoxFormer,9,70,44,83,79,127,457.5791361991285,800.5801550184921,5.335714285714285,4271.666969991526,237.31483166619586,0.26686005167283067
35,VoxFormer,0,0,0,0,0,0,0,0,0,0,0.0,0.0
36,VoxFormer,10,37,29,58,47,87,225.9690554771448,483.2492300959545,7.837837837837838,3787.629100752076,210.42383893067088,0.1610830766986515
37,VoxFormer,0,0,0,0,0,0,0,0,0,0,0.0,0.0
38,VoxFormer,6,14,9,18,20,27,68.81274391313339,116.69205856195879,3.857142857142857,450.09794016755535,25.005441120419743,0.03889735285398626
39,VoxFormer,0,0,0,0,0,0,0,0,0,0,0.0,0.0
40,VoxFormer,4,15,9,18,19,27,66.60335893412778,114.6940428629768,2.4,275.2657028711443,15.292539048396906,0.03823134762099227
41,VoxFormer,2,4,2,4,6,6,10.0,15.509775004326936,1.0,15.509775004326936,0.861654166907052,0.005169925001442312
42,VoxFormer,0,0,0,0,0,0,0,0,0,0,0.0,0.0
43,VoxFormer,0,0,0,0,0,0,0,0,0,0,0.0,0.0
44,VoxFormer,7,19,16,25,26,41,100.36210720983135,192.7180284437848,4.605263157894737,887.5172362542721,49.30651312523734,0.06423934281459492
45,VoxFormer,0,0,0,0,0,0,0,0,0,0,0.0,0.0
46,VoxFormer,5,10,12,18,15,30,44.82892142331043,117.20671786825557,4.5,527.43023040715,29.30167946706389,0.03906890595608519
47,VoxFormer,5,7,8,14,12,22,31.26112492884004,78.86917501586544,5.0,394.3458750793272,21.90810417107373,0.026289725005288478
48,VoxFormer,5,7,8,14,12,22,31.26112492884004,78.86917501586544,5.0,394.3458750793272,21.90810417107373,0.026289725005288478
49,VoxFormer,10,83,54,102,93,156,562.3475537506683,1020.108774532853,6.144578313253012,6268.138253153675,348.22990295298194,0.3400362581776177
50,VoxFormer,12,72,69,137,84,206,487.2541501125003,1316.8173890924245,11.416666666666666,15033.665192138513,835.2036217854729,0.43893912969747484
51,VoxFormer,14,135,94,172,149,266,1008.6730745106687,1920.298826442935,8.91851851851852,17126.220644720695,951.4567024844831,0.6400996088143117
52,VoxFormer,9,22,13,22,31,35,126.63682062300134,173.39687086354064,4.5,780.2859188859329,43.34921771588516,0.05779895695451355
53,VoxFormer,6,29,16,29,35,45,156.39122386302654,230.81773576252348,3.0,692.4532072875704,38.46962262708725,0.07693924525417449
54,VoxFormer,6,16,12,18,22,30,79.50977500432694,133.78294855911892,3.375,451.51745138702637,25.0843028548348,0.044594316186372975
55,VoxFormer,4,7,5,9,11,14,27.651484454403228,48.43204266092217,2.5714285714285716,124.53953827094274,6.918863237274596,0.016144014220307392
56,VoxFormer,0,0,0,0,0,0,0,0,0,0,0.0,0.0
57,VoxFormer,7,31,67,134,38,201,173.2315700763964,1054.8334302021606,15.129032258064516,15958.608992413332,886.5893884674074,0.3516111434007202
58,VoxFormer,6,24,13,26,30,39,125.5488750216347,191.36873322873222,3.25,621.9483829933797,34.55268794407665,0.06378957774291075
59,VoxFormer,7,39,35,63,46,98,225.78217099003092,541.3090716935873,5.653846153846154,3060.4782130368203,170.02656739093447,0.18043635723119575
60,VoxFormer,0,0,0,0,0,0,0,0,0,0,0.0,0.0
61,VoxFormer,7,28,30,60,35,90,154.25742227201613,461.63547152504697,7.5,3462.266036437852,192.34811313543622,0.15387849050834898
62,VoxFormer,9,42,24,44,51,68,255.00665676968876,385.7249232540617,4.714285714285714,1818.4174953405766,101.02319418558758,0.12857497441802057
63,VoxFormer,5,21,25,49,26,74,103.84830635279079,347.83253914244085,5.833333333333333,2029.0231449975715,112.72350805542064,0.11594417971414694
64,VoxFormer,4,21,24,48,25,72,100.23866587835397,334.35764566378015,4.571428571428571,1528.4920944629948,84.91622747016638,0.11145254855459338
65,VoxFormer,0,0,0,0,0,0,0,0,0,0,0.0,0.0
66,VoxFormer,12,45,32,63,57,95,290.15293934348927,554.1245513456505,8.4,4654.646231303464,258.59145729463694,0.1847081837818835
67,pylot,6,27,17,31,33,48,143.89173756274062,242.13091772920575,3.4444444444444446,834.0064944005976,46.333694133366535,0.08071030590973526
68,pylot,6,18,13,25,24,38,90.56842503028855,174.22857502740396,4.166666666666667,725.9523959475166,40.33068866375092,0.058076191675801324
69,pylot,0,0,0,0,0,0,0,0,0,0,0.0,0.0
70,pylot,4,14,9,18,18,27,61.30296890880645,112.58797503894243,2.5714285714285716,289.5119358144234,16.083996434134633,0.03752932501298081
71,pylot,5,110,53,110,115,163,757.5592089621493,1115.8148783039333,2.5,2789.537195759833,154.97428865332407,0.37193829276797774
72,pylot,0,0,0,0,0,0,0,0,0,0,0.0,0.0
73,pylot,7,85,59,107,92,166,564.4497140261079,1082.9112847054641,4.405882352941177,4771.179719084663,265.06553994914793,0.36097042823515474
74,pylot,16,275,249,478,291,727,2292.4041473133066,5950.404374294323,13.905454545454546,82743.0775538236,4596.8376418790895,1.9834681247647743
75,pylot,6,55,34,71,61,105,333.4845592481832,622.7274204441031,3.8727272727272726,2411.653464628981,133.9807480349434,0.20757580681470103
76,pylot,4,6,4,8,10,12,23.509775004326936,39.863137138648355,2.6666666666666665,106.3016990363956,5.905649946466422,0.013287712379549451
77,pylot,5,8,5,10,13,15,35.60964047443681,55.506595772116384,3.125,173.4581117878637,9.636561765992427,0.01850219859070546
78,pylot,4,6,4,8,10,12,23.509775004326936,39.863137138648355,2.6666666666666665,106.3016990363956,5.905649946466422,0.013287712379549451
79,pylot,0,0,0,0,0,0,0,0,0,0,0.0,0.0
80,pylot,4,6,4,8,10,12,23.509775004326936,39.863137138648355,2.6666666666666665,106.3016990363956,5.905649946466422,0.013287712379549451
81,pylot,3,5,3,6,8,9,16.36452797660028,27.0,1.8,48.6,2.7,0.009
82,pylot,4,6,4,8,10,12,23.509775004326936,39.863137138648355,2.6666666666666665,106.3016990363956,5.905649946466422,0.013287712379549451
83,pylot,4,6,4,8,10,12,23.509775004326936,39.863137138648355,2.6666666666666665,106.3016990363956,5.905649946466422,0.013287712379549451
84,pylot,4,6,4,8,10,12,23.509775004326936,39.863137138648355,2.6666666666666665,106.3016990363956,5.905649946466422,0.013287712379549451
85,pylot,12,48,34,62,60,96,311.0977500432694,567.0614971784178,7.75,4394.726603132738,244.15147795181878,0.1890204990594726
86,pylot,5,19,10,20,24,30,92.32026322986493,137.5488750216347,2.6315789473684212,361.97072374114396,20.109484652285776,0.04584962500721157
87,pylot,5,13,9,17,18,26,59.715356810271004,108.41805003750011,3.269230769230769,354.44362512259653,19.691312506810917,0.036139350012500036
88,pylot,5,7,5,9,12,14,31.26112492884004,50.18947501009619,3.2142857142857144,161.32331253245204,8.962406251802891,0.016729825003365395
89,pylot,6,9,6,11,15,17,44.039100017307746,66.41714012534482,3.6666666666666665,243.52951379293097,13.52941743294061,0.02213904670844827
90,pylot,5,7,5,9,12,14,31.26112492884004,50.18947501009619,3.2142857142857144,161.32331253245204,8.962406251802891,0.016729825003365395
91,pylot,1,2,1,2,3,3,2.0,4.754887502163469,0.5,2.3774437510817346,0.1320802083934297,0.0015849625007211565
92,pylot,0,0,0,0,0,0,0,0,0,0,0.0,0.0
93,pylot,5,11,8,15,16,23,49.663388279447084,92.0,3.409090909090909,313.6363636363636,17.424242424242422,0.030666666666666665
94,pylot,11,56,41,75,67,116,363.26562344023614,703.6663460931015,7.366071428571429,5183.25656720365,287.9586981779805,0.2345554486977005
95,pylot,10,40,28,51,50,79,246.09640474436813,445.8646389922032,6.375,2842.3870735752953,157.9103929764053,0.1486215463307344
96,pylot,4,8,5,10,12,15,32.0,53.77443751081735,2.5,134.43609377704337,7.468671876502409,0.017924812503605784
97,pylot,1,2,1,2,3,3,2.0,4.754887502163469,0.5,2.3774437510817346,0.1320802083934297,0.0015849625007211565
98,pylot,5,8,6,11,13,17,35.60964047443681,62.907475208398566,3.4375,216.24444602887007,12.013580334937226,0.02096915840279952
99,pylot,1,2,1,2,3,3,2.0,4.754887502163469,0.5,2.3774437510817346,0.1320802083934297,0.0015849625007211565
100,pylot,4,13,7,14,17,21,56.105716335834195,85.83671966625714,2.1538461538461537,184.87908851193845,10.27106047288547,0.02861223988875238
101,pylot,0,0,0,0,0,0,0,0,0,0,0.0,0.0
102,pylot,2,4,4,6,6,10,10.0,25.84962500721156,1.5,38.77443751081734,2.1541354172676304,0.00861654166907052
103,pylot,0,0,0,0,0,0,0,0,0,0,0.0,0.0
104,pylot,5,21,17,29,26,46,103.84830635279079,216.22022703449025,3.4523809523809526,746.4745933333593,41.47081074074218,0.07207340901149675
105,pylot,0,0,0,0,0,0,0,0,0,0,0.0,0.0
106,pylot,5,27,37,68,32,105,139.9916030328505,525.0,6.296296296296297,3305.5555555555557,183.64197530864197,0.175
107,pylot,5,20,12,23,25,35,98.04820237218406,162.53496664211536,2.875,467.2880290960817,25.960446060893428,0.054178322214038455
108,pylot,12,51,41,77,63,118,332.3132424492002,705.3190309729902,9.058823529411764,6389.360633520028,354.96447964000157,0.2351063436576634
109,pylot,1,2,1,2,3,3,2.0,4.754887502163469,0.5,2.3774437510817346,0.1320802083934297,0.0015849625007211565
110,pylot,14,133,97,181,147,278,991.6555328304646,2001.5089118645094,9.526315789473685,19067.00594986717,1059.2781083259538,0.6671696372881698
111,pylot,12,43,26,50,55,76,276.3489344608441,439.38333822787416,6.976744186046512,3065.465150427029,170.30361946816828,0.14646111274262472
112,pylot,0,0,0,0,0,0,0,0,0,0,0.0,0.0
113,pylot,10,31,22,42,41,64,186.7993665708668,342.88332829555736,6.774193548387097,2322.7580303892596,129.0421127994033,0.11429444276518579
114,pylot,0,0,0,0,0,0,0,0,0,0,0.0,0.0
115,pylot,6,41,36,67,47,103,235.16940719366838,572.1226517227967,4.902439024390244,2804.7964145434667,155.82202303019258,0.19070755057426558
116,pylot,0,0,0,0,0,0,0,0,0,0,0.0,0.0
117,pylot,4,8,4,8,12,12,32.0,43.01955000865388,2.0,86.03910001730776,4.779950000961542,0.014339850002884626
118,pylot,0,0,0,0,0,0,0,0,0,0,0.0,0.0
119,pylot,0,0,0,0,0,0,0,0,0,0,0.0,0.0
120,pylot,4,8,4,8,12,12,32.0,43.01955000865388,2.0,86.03910001730776,4.779950000961542,0.014339850002884626
121,pylot,0,0,0,0,0,0,0,0,0,0,0.0,0.0
122,pylot,0,0,0,0,0,0,0,0,0,0,0.0,0.0
123,pylot,0,0,0,0,0,0,0,0,0,0,0.0,0.0
124,pylot,0,0,0,0,0,0,0,0,0,0,0.0,0.0
125,pylot,6,13,9,16,19,25,63.61549134016113,106.19818783608963,3.6923076923076925,392.11638585633096,21.784243658685053,0.03539939594536321
126,pylot,5,10,6,11,15,17,44.82892142331043,66.41714012534482,2.75,182.64713534469826,10.147063074705459,0.02213904670844827
127,pylot,11,28,20,36,39,56,172.65968562262316,295.98252425628596,7.071428571428571,2093.0192786694506,116.27884881496948,0.09866084141876198
128,pylot,3,16,13,22,19,35,68.75488750216347,148.67746297052548,2.0625,306.6472673767088,17.035959298706043,0.04955915432350849
129,pylot,0,0,0,0,0,0,0,0,0,0,0.0,0.0
130,pylot,6,15,8,16,21,24,74.11313393845472,105.41561814669026,3.2,337.32997806940887,18.74055433718938,0.03513853938223009
131,pylot,6,11,6,12,17,18,53.563522809337215,73.57433114250613,3.272727272727273,240.78872010274733,13.377151116819297,0.02452477704750204
132,pylot,14,92,61,117,106,178,653.4706688660516,1197.5698409122494,8.902173913043478,10660.974996816656,592.2763887120365,0.39918994697074983
133,pylot,16,91,68,126,107,194,656.2093122580814,1307.8445953618225,11.076923076923077,14486.893979392495,804.827443299583,0.43594819845394084
134,pylot,1,6,6,6,7,12,15.509775004326936,33.68825906469125,0.5,16.844129532345626,0.9357849740192015,0.011229419688230418
135,pylot,3,7,4,8,10,12,24.406371956566698,39.863137138648355,1.7142857142857142,68.33680652339717,3.796489251299843,0.013287712379549451
136,pylot,0,0,0,0,0,0,0,0,0,0,0.0,0.0
137,pylot,13,67,39,76,80,115,454.5336920965049,727.0217309120466,7.373134328358209,5360.428881650016,297.801604536112,0.24234057697068218
138,pylot,10,47,32,58,57,90,294.2849569777226,524.9601012748268,6.170212765957447,3239.1155185042508,179.95086213912504,0.17498670042494227
139,pylot,0,0,0,0,0,0,0,0,0,0,0.0,0.0
140,pylot,6,31,19,35,37,54,169.0898606263201,281.3104817439633,3.3870967741935485,952.8258252618111,52.93476807010062,0.0937701605813211
141,pylot,0,0,0,0,0,0,0,0,0,0,0.0,0.0
142,pylot,13,67,45,80,80,125,454.5336920965049,790.2410118609203,7.7611940298507465,6133.213823398187,340.7341012998993,0.26341367062030674
143,pylot,11,44,30,58,55,88,278.26873902505133,508.7596547901701,7.25,3688.507497228733,204.91708317937406,0.16958655159672337
144,pylot,8,35,25,45,43,70,203.5249055930738,379.83853282914686,5.142857142857143,1953.4553116927555,108.52529509404197,0.12661284427638228
145,pylot,7,26,17,28,33,45,141.86291712607164,226.9977353711304,3.769230769230769,855.6068487065684,47.533713817031575,0.07566591179037681
146,pylot,1,2,1,2,3,3,2.0,4.754887502163469,0.5,2.3774437510817346,0.1320802083934297,0.0015849625007211565
147,pylot,0,0,0,0,0,0,0,0,0,0,0.0,0.0
148,pylot,15,56,48,91,71,139,383.8152345693536,854.8148496111509,12.1875,10418.055979635901,578.7808877575501,0.28493828320371695
149,pylot,4,9,8,10,13,18,36.52932501298081,66.60791492653966,2.2222222222222223,148.0175887256437,8.223199373646871,0.022202638308846556
150,pylot,8,23,12,23,31,35,128.0419249893113,173.39687086354064,4.0,693.5874834541626,38.5326379696757,0.05779895695451355
151,pylot,8,31,20,37,39,57,177.58008562199316,301.26792647514816,4.774193548387097,1438.3113909136107,79.90618838408949,0.10042264215838272
152,pylot,0,0,0,0,0,0,0,0,0,0,0.0,0.0
153,pylot,2,4,2,4,6,6,10.0,15.509775004326936,1.0,15.509775004326936,0.861654166907052,0.005169925001442312
154,pylot,3,6,3,6,9,9,20.264662506490406,28.529325012980813,1.5,42.793987519471216,2.377443751081734,0.009509775004326938
155,pylot,10,64,39,74,74,113,417.21928094887363,701.6682303160715,5.78125,4056.519456514788,225.36219202859934,0.23388941010535716
156,pylot,0,0,0,0,0,0,0,0,0,0,0.0,0.0
157,pylot,6,19,10,20,25,30,96.22039775975506,139.31568569324173,3.1578947368421053,439.9442706102371,24.441348367235392,0.04643856189774724
158,pylot,12,43,33,65,55,98,276.3489344608441,566.5732519254167,9.069767441860465,5138.687633742152,285.48264631900844,0.18885775064180557
159,pylot,0,0,0,0,0,0,0,0,0,0,0.0,0.0
160,pylot,1,8,4,8,9,12,24.0,38.03910001730775,0.5,19.019550008653876,1.0566416671474377,0.012679700005769252
161,pylot,4,8,4,8,12,12,32.0,43.01955000865388,2.0,86.03910001730776,4.779950000961542,0.014339850002884626
162,pylot,2,6,3,6,8,9,17.509775004326936,27.0,1.0,27.0,1.5,0.009
163,pylot,10,28,19,36,38,55,167.82521876648653,288.6360132393972,6.428571428571429,1855.5172279675535,103.08429044264186,0.0962120044131324
164,pylot,9,35,24,47,44,71,208.05423060605463,387.61964492324813,6.042857142857143,2342.3301400361993,130.1294522242333,0.12920654830774939
165,pylot,2,6,3,6,8,9,17.509775004326936,27.0,1.0,27.0,1.5,0.009
166,pylot,0,0,0,0,0,0,0,0,0,0,0.0,0.0
167,pylot,14,82,62,122,96,184,574.6222332874894,1211.6331001326928,10.414634146341463,12618.715457479508,701.0397476377505,0.4038777000442309
168,pylot,7,23,15,31,30,46,123.69340944371453,225.71696739799185,4.717391304347826,1064.7952592470485,59.155292180391584,0.07523898913266396
169,pylot,0,0,0,0,0,0,0,0,0,0,0.0,0.0
170,pylot,5,13,7,14,18,21,59.715356810271004,87.56842503028855,2.6923076923076925,235.76114431231534,13.097841350684185,0.029189475010096184
171,pylot,7,17,12,22,24,34,89.13835275565901,155.88872502451935,4.529411764705882,706.0842251110582,39.22690139505879,0.05196290834150645
172,pylot,0,0,0,0,0,0,0,0,0,0,0.0,0.0
173,pylot,13,57,54,107,70,161,380.5804471432245,986.8145657281398,12.201754385964913,12040.86895550739,668.9371641948551,0.32893818857604656
174,pylot,8,21,12,24,29,36,116.23866587835397,174.88731582459263,4.571428571428571,799.4848723409948,44.41582624116638,0.05829577194153088
175,pylot,16,103,144,192,119,336,752.7095542998715,2316.658768471469,14.912621359223301,34547.45503273958,1919.3030573744209,0.7722195894904897
176,pylot,3,6,4,6,9,10,20.264662506490406,31.699250014423125,1.5,47.548875021634686,2.6416041678685938,0.010566416671474375
177,pylot,0,0,0,0,0,0,0,0,0,0,0.0,0.0
178,pylot,1,1,1,1,2,2,0.0,2.0,0.5,1.0,0.05555555555555555,0.0006666666666666666
179,pylot,6,20,11,22,26,33,101.94833690207419,155.11451069865606,3.3,511.877885305565,28.43766029475361,0.05170483689955202
180,pylot,15,42,27,52,57,79,285.0806906908357,460.7983111190146,9.285714285714286,4278.84146039085,237.71341446615835,0.15359943703967155
181,pylot,18,173,154,274,191,428,1361.2493334071153,3243.1395383993004,14.254335260115607,46228.7982756802,2568.2665708711224,1.0810465127997668
182,pylot,15,74,50,91,89,141,518.1029079906701,913.0784137662621,9.222972972972974,8421.297532371269,467.84986290951497,0.3043594712554207
183,pylot,4,12,7,14,16,21,51.01955000865388,84.0,2.3333333333333335,196.0,10.88888888888889,0.028
184,pylot,9,40,22,44,49,66,241.40644880847532,370.5708497116037,4.95,1834.3257060724386,101.90698367069103,0.12352361657053458
185,pylot,9,29,24,47,38,71,169.41077387168042,372.60285345449455,7.293103448275862,2717.4311553663997,150.96839752035555,0.12420095115149818
186,pylot,9,36,31,57,45,88,214.64662506490404,483.2830724770114,7.125,3443.3918913987063,191.29954952215036,0.16109435749233714
187,pylot,7,45,39,70,52,109,266.7848737892386,621.3479292773791,5.444444444444445,3382.894281621286,187.93857120118255,0.20711597642579302
188,pylot,9,19,11,21,28,32,109.23994776840894,153.83535750584332,4.973684210526316,765.1284886474839,42.50713825819355,0.05127845250194777
189,pylot,0,0,0,0,0,0,0,0,0,0,0.0,0.0
190,pylot,0,0,0,0,0,0,0,0,0,0,0.0,0.0
191,pylot,3,6,5,9,9,14,20.264662506490406,44.37895002019238,2.25,99.85263754543286,5.547368752524047,0.014792983340064125
192,pylot,2,5,3,6,7,9,13.60964047443681,25.26619429851844,1.2,30.319433158222125,1.6844129532345624,0.008422064766172813
193,pylot,9,23,16,29,32,45,132.57125000229212,225.0,5.673913043478261,1276.6304347826087,70.92391304347827,0.075
194,pylot,4,12,10,19,16,29,51.01955000865388,116.0,3.1666666666666665,367.3333333333333,20.407407407407405,0.03866666666666667
195,pylot,3,8,7,11,11,18,28.75488750216347,62.26976913547136,2.0625,128.43139884190967,7.135077713439426,0.020756589711823786
196,pylot,0,0,0,0,0,0,0,0,0,0,0.0,0.0
197,pylot,13,177,131,254,190,385,1369.8718987005248,2914.394409207415,9.32768361581921,27184.548980799107,1510.252721155506,0.9714648030691383
198,pylot,14,155,120,229,169,349,1181.1022517263134,2582.9069232624825,10.341935483870968,26712.256761224253,1484.0142645124586,0.8609689744208275
199,pylot,0,0,0,0,0,0,0,0,0,0,0.0,0.0
200,pylot,12,61,39,71,73,110,404.79452759999,680.880701476802,6.983606557377049,4755.002931624879,264.16682953471553,0.22696023382560065
201,pylot,0,0,0,0,0,0,0,0,0,0,0.0,0.0
202,pylot,4,8,5,10,12,15,32.0,53.77443751081735,2.5,134.43609377704337,7.468671876502409,0.017924812503605784
203,pylot,11,73,44,94,84,138,489.91094060325156,882.1398043434689,7.082191780821918,6247.483271857171,347.08240399206505,0.29404660144782296
204,pylot,0,0,0,0,0,0,0,0,0,0,0.0,0.0
205,pylot,0,0,0,0,0,0,0,0,0,0,0.0,0.0
206,pylot,17,121,86,169,138,255,906.6693200114818,1812.6737364784333,11.87190082644628,21519.88283017578,1195.5490461208765,0.6042245788261444
207,pylot,5,16,9,18,21,27,75.60964047443682,118.59257041502654,2.8125,333.54160429226215,18.530089127347896,0.03953085680500885
208,pylot,2,6,3,6,8,9,17.509775004326936,27.0,1.0,27.0,1.5,0.009
209,pylot,4,17,12,24,21,36,77.48686830125578,158.12342722003538,2.823529411764706,446.4661474448058,24.80367485804477,0.05270780907334513
210,pylot,5,14,8,14,19,22,64.91260938324326,93.45440529575887,2.5,233.6360132393972,12.979778513299843,0.031151468431919623
211,pylot,0,0,0,0,0,0,0,0,0,0,0.0,0.0
212,pylot,3,10,5,10,13,15,37.974168451037094,55.506595772116384,1.5,83.25989365817458,4.625549647676365,0.01850219859070546
213,pylot,0,0,0,0,0,0,0,0,0,0,0.0,0.0
214,pylot,10,31,19,35,41,54,186.7993665708668,289.30780824937654,5.645161290322581,1633.1892401174482,90.73273556208045,0.0964359360831255
215,pylot,7,44,34,63,51,97,259.8664756744443,550.2252581712352,5.011363636363637,2757.378850608122,153.18771392267342,0.18340841939041172
216,pylot,2,25,13,26,27,39,118.09640474436812,185.4406125843753,1.04,192.8582370877503,10.714346504875017,0.061813537528125094
217,pylot,9,59,39,73,68,112,375.60526492532944,681.795838220038,5.567796610169491,3796.100556869195,210.89447538162193,0.22726527940667934
218,pylot,4,14,9,17,18,26,61.30296890880645,108.41805003750011,2.4285714285714284,263.30097866250026,14.627832147916681,0.036139350012500036
219,pylot,2,6,3,6,8,9,17.509775004326936,27.0,1.0,27.0,1.5,0.009
220,pylot,3,6,3,6,9,9,20.264662506490406,28.529325012980813,1.5,42.793987519471216,2.377443751081734,0.009509775004326938
221,pylot,3,17,12,24,20,36,74.24175580341925,155.58941141594505,2.1176470588235294,329.4834594690601,18.304636637170006,0.05186313713864835
222,pylot,9,58,36,73,67,109,368.29222273037993,661.2037217598971,5.663793103448276,3744.921079278038,208.05117107100213,0.22040124058663238
223,pylot,10,31,19,35,41,54,186.7993665708668,289.30780824937654,5.645161290322581,1633.1892401174482,90.73273556208045,0.0964359360831255
224,pylot,0,0,0,0,0,0,0,0,0,0,0.0,0.0
225,Cam2BEV,4,7,5,9,11,14,27.651484454403228,48.43204266092217,2.5714285714285716,124.53953827094274,6.918863237274596,0.016144014220307392
226,Cam2BEV,11,69,48,83,80,131,459.54193532270403,828.1725804302444,6.615942028985507,5479.141782121834,304.3967656734352,0.27605752681008144
227,Cam2BEV,5,12,10,18,17,28,54.62919048309069,114.44895955500952,3.75,429.18359833128574,23.843533240626986,0.03814965318500317
228,Cam2BEV,9,19,14,25,28,39,109.23994776840894,187.48684196024655,5.921052631578948,1110.1194589751442,61.6733032763969,0.06249561398674885
229,Cam2BEV,0,0,0,0,0,0,0,0,0,0,0.0,0.0
230,Cam2BEV,0,0,0,0,0,0,0,0,0,0,0.0,0.0
231,Cam2BEV,6,27,17,33,33,50,143.89173756274062,252.21970596792266,3.6666666666666665,924.8055885490497,51.378088252724986,0.08407323532264088
232,Cam2BEV,14,93,75,145,107,220,661.4447383418534,1483.1227370082522,10.913978494623656,16186.769656595441,899.2649809219689,0.4943742456694174
233,Cam2BEV,6,55,50,93,61,143,333.4845592481832,848.0954392714928,5.072727272727272,4302.156864668117,239.00871470378428,0.2826984797571642
234,Cam2BEV,17,118,73,139,135,212,881.638748125953,1500.2849065747764,10.01271186440678,15021.920484051681,834.5511380028712,0.5000949688582588
235,Cam2BEV,10,82,66,107,92,173,554.5385453275566,1128.5762183978632,6.524390243902439,7363.271668815327,409.07064826751815,0.37619207279928774
236,Cam2BEV,7,50,35,65,57,100,301.8442939431394,583.2890014164742,4.55,2653.9649564449574,147.44249758027541,0.19442966713882473
237,Cam2BEV,1,17,17,17,18,34,69.48686830125578,141.7774500490386,0.5,70.8887250245193,3.9382625013621837,0.0472591500163462
238,Cam2BEV,1,1,1,1,2,2,0.0,2.0,0.5,1.0,0.05555555555555555,0.0006666666666666666
239,PythonRobotics,0,0,0,0,0,0,0,0,0,0,0.0,0.0
240,PythonRobotics,0,0,0,0,0,0,0,0,0,0,0.0,0.0
241,PythonRobotics,6,54,35,70,60,105,326.27370012115426,620.2235125388945,3.888888888888889,2411.980326540145,133.99890703000807,0.20674117084629817
242,PythonRobotics,12,26,15,28,38,43,165.23098268032228,225.66088307807416,6.461538461538462,1458.11647527371,81.00647084853944,0.07522029435935805
243,PythonRobotics,8,83,84,162,91,246,553.1282728017948,1600.9174814888793,7.807228915662651,12498.729253069805,694.373847392767,0.5336391604962931
244,PythonRobotics,7,78,50,100,85,150,509.9128575256586,961.4086404206554,4.487179487179487,4314.013130092684,239.66739611626022,0.3204695468068851
245,PythonRobotics,0,0,0,0,0,0,0,0,0,0,0.0,0.0
246,PythonRobotics,15,100,71,126,115,197,722.9889779116003,1348.561540036042,9.45,12743.906553340597,707.9948085189221,0.4495205133453474
247,PythonRobotics,11,45,32,61,56,93,285.1871371398456,540.0840077513573,7.455555555555556,4026.6263244573415,223.70146246985232,0.18002800258378576
248,PythonRobotics,10,74,55,103,84,158,492.718830005416,1009.986152799044,6.95945945945946,7028.957685020374,390.49764916779856,0.33666205093301466
249,PythonRobotics,0,0,0,0,0,0,0,0,0,0,0.0,0.0
250,PythonRobotics,9,75,61,118,84,179,495.69072680017183,1144.224818677398,7.08,8101.111716235978,450.0617620131099,0.381408272892466
251,PythonRobotics,14,113,77,141,127,218,823.9831916617227,1523.5332617163322,8.734513274336283,13307.321498354158,739.2956387974532,0.5078444205721108
252,PythonRobotics,8,47,29,54,55,83,285.06567602884894,479.8528562225468,4.595744680851064,2205.28121157596,122.5156228653311,0.15995095207418225
253,PythonRobotics,0,0,0,0,0,0,0,0,0,0,0.0,0.0
254,PythonRobotics,14,165,115,221,179,336,1268.7461342593658,2514.56210116079,9.375757575757575,23575.924669671163,1309.773592759509,0.8381873670535966
255,PythonRobotics,5,14,8,15,19,23,64.91260938324326,97.70233280920246,2.6785714285714284,261.7026771675066,14.539037620417032,0.03256744426973415
256,PythonRobotics,10,41,41,78,51,119,252.87891313821507,675.018615694608,9.512195121951219,6420.908783436515,356.7171546353619,0.225006205231536
257,PythonRobotics,0,0,0,0,0,0,0,0,0,0,0.0,0.0
258,PythonRobotics,0,0,0,0,0,0,0,0,0,0,0.0,0.0
259,PythonRobotics,0,0,0,0,0,0,0,0,0,0,0.0,0.0
260,PythonRobotics,0,0,0,0,0,0,0,0,0,0,0.0,0.0
261,PythonRobotics,3,15,8,16,18,24,63.35824643629125,100.07820003461549,1.6,160.1251200553848,8.895840003076934,0.0333594000115385
262,PythonRobotics,0,0,0,0,0,0,0,0,0,0,0.0,0.0
263,PythonRobotics,4,55,29,55,59,84,325.9747842438563,494.14201614639467,2.0,988.2840322927893,54.90466846071052,0.16471400538213155
264,PythonRobotics,14,201,144,277,215,421,1591.164358835771,3261.9891896771624,9.64676616915423,31467.646959124468,1748.202608840248,1.0873297298923874
265,PythonRobotics,10,92,60,113,102,173,633.3869809061188,1154.3295841610686,6.141304347826087,7089.089294032649,393.838294112925,0.38477652805368956
266,PythonRobotics,11,163,102,196,174,298,1235.896436944676,2217.997161762921,6.613496932515337,14668.717425646804,814.9287458692669,0.739332387254307
267,PythonRobotics,14,218,155,299,232,454,1746.7671517101762,3567.5233717879178,9.600917431192661,34251.497326385834,1902.8609625769907,1.1891744572626393
268,PythonRobotics,0,0,0,0,0,0,0,0,0,0,0.0,0.0
269,PythonRobotics,12,110,74,143,122,217,788.9691184963665,1503.9700022511463,7.8,11730.966017558942,651.72033430883,0.5013233340837154
270,PythonRobotics,14,151,108,200,165,308,1146.3020845468934,2268.827241987711,9.271523178807946,21035.48436279997,1168.638020155554,0.7562757473292371
271,PythonRobotics,13,145,96,180,158,276,1089.1925343879996,2015.8434864968804,8.068965517241379,16265.771580698965,903.653976705498,0.6719478288322934
272,PythonRobotics,10,280,255,483,290,738,2309.4185256934643,6036.772908431021,8.625,52067.16633521756,2892.620351956531,2.0122576361436737
273,PythonRobotics,17,315,259,471,332,730,2683.737394093249,6113.778784883254,12.709523809523809,77703.21703263526,4316.845390701959,2.037926261627751
274,PythonRobotics,0,0,0,0,0,0,0,0,0,0,0.0,0.0
275,PythonRobotics,14,150,104,192,164,296,1137.6257724831885,2177.835393366953,8.96,19513.405124567904,1084.0780624759946,0.7259451311223177
276,PythonRobotics,10,76,53,99,86,152,508.06177197058616,976.7922427147189,6.5131578947368425,6362.002107155077,353.4445615086154,0.3255974142382396
277,PythonRobotics,1,2,1,2,3,3,2.0,4.754887502163469,0.5,2.3774437510817346,0.1320802083934297,0.0015849625007211565
278,PythonRobotics,1,2,1,2,3,3,2.0,4.754887502163469,0.5,2.3774437510817346,0.1320802083934297,0.0015849625007211565
279,PythonRobotics,1,2,1,2,3,3,2.0,4.754887502163469,0.5,2.3774437510817346,0.1320802083934297,0.0015849625007211565
280,PythonRobotics,1,2,1,2,3,3,2.0,4.754887502163469,0.5,2.3774437510817346,0.1320802083934297,0.0015849625007211565
281,PythonRobotics,1,2,1,2,3,3,2.0,4.754887502163469,0.5,2.3774437510817346,0.1320802083934297,0.0015849625007211565
282,PythonRobotics,6,51,39,69,57,108,304.8034674448732,629.9521215297922,4.0588235294117645,2556.86449326798,142.04802740377667,0.20998404050993072
283,PythonRobotics,1,2,1,2,3,3,2.0,4.754887502163469,0.5,2.3774437510817346,0.1320802083934297,0.0015849625007211565
284,PythonRobotics,3,7,7,9,10,16,24.406371956566698,53.1508495181978,1.9285714285714286,102.50520978509576,5.694733876949765,0.017716949839399268
285,PythonRobotics,2,7,10,11,9,21,21.651484454403228,66.56842503028857,1.5714285714285714,104.60752504759631,5.811529169310906,0.022189475010096188
286,PythonRobotics,0,0,0,0,0,0,0,0,0,0,0.0,0.0
287,PythonRobotics,3,19,15,28,22,43,85.46551025759159,191.75555960140377,2.210526315789474,423.88071069783996,23.54892837210222,0.0639185198671346
288,PythonRobotics,1,2,1,2,3,3,2.0,4.754887502163469,0.5,2.3774437510817346,0.1320802083934297,0.0015849625007211565
289,PythonRobotics,1,2,1,2,3,3,2.0,4.754887502163469,0.5,2.3774437510817346,0.1320802083934297,0.0015849625007211565
290,PythonRobotics,1,2,1,2,3,3,2.0,4.754887502163469,0.5,2.3774437510817346,0.1320802083934297,0.0015849625007211565
291,PythonRobotics,1,2,1,2,3,3,2.0,4.754887502163469,0.5,2.3774437510817346,0.1320802083934297,0.0015849625007211565
292,PythonRobotics,1,2,1,2,3,3,2.0,4.754887502163469,0.5,2.3774437510817346,0.1320802083934297,0.0015849625007211565
293,PythonRobotics,3,8,5,8,11,13,28.75488750216347,44.97261104228487,1.5,67.4589165634273,3.747717586857072,0.01499087034742829
294,PythonRobotics,1,2,1,2,3,3,2.0,4.754887502163469,0.5,2.3774437510817346,0.1320802083934297,0.0015849625007211565
295,PythonRobotics,1,2,1,2,3,3,2.0,4.754887502163469,0.5,2.3774437510817346,0.1320802083934297,0.0015849625007211565
296,PythonRobotics,1,2,1,2,3,3,2.0,4.754887502163469,0.5,2.3774437510817346,0.1320802083934297,0.0015849625007211565
297,PythonRobotics,1,2,1,2,3,3,2.0,4.754887502163469,0.5,2.3774437510817346,0.1320802083934297,0.0015849625007211565
298,PythonRobotics,1,2,1,2,3,3,2.0,4.754887502163469,0.5,2.3774437510817346,0.1320802083934297,0.0015849625007211565
299,PythonRobotics,1,2,1,2,3,3,2.0,4.754887502163469,0.5,2.3774437510817346,0.1320802083934297,0.0015849625007211565
300,PythonRobotics,1,2,1,2,3,3,2.0,4.754887502163469,0.5,2.3774437510817346,0.1320802083934297,0.0015849625007211565
301,PythonRobotics,1,2,1,2,3,3,2.0,4.754887502163469,0.5,2.3774437510817346,0.1320802083934297,0.0015849625007211565
302,PythonRobotics,1,2,1,2,3,3,2.0,4.754887502163469,0.5,2.3774437510817346,0.1320802083934297,0.0015849625007211565
303,PythonRobotics,1,4,2,4,5,6,8.0,13.931568569324174,0.5,6.965784284662087,0.3869880158145604,0.004643856189774725
304,PythonRobotics,1,2,1,2,3,3,2.0,4.754887502163469,0.5,2.3774437510817346,0.1320802083934297,0.0015849625007211565
305,PythonRobotics,1,2,1,2,3,3,2.0,4.754887502163469,0.5,2.3774437510817346,0.1320802083934297,0.0015849625007211565
306,PythonRobotics,1,2,1,2,3,3,2.0,4.754887502163469,0.5,2.3774437510817346,0.1320802083934297,0.0015849625007211565
307,PythonRobotics,1,2,1,2,3,3,2.0,4.754887502163469,0.5,2.3774437510817346,0.1320802083934297,0.0015849625007211565
308,PythonRobotics,1,2,1,2,3,3,2.0,4.754887502163469,0.5,2.3774437510817346,0.1320802083934297,0.0015849625007211565
309,PythonRobotics,6,45,32,61,51,93,262.6431643391623,527.5355568033491,4.066666666666666,2145.3112643336194,119.18395912964553,0.17584518560111637
310,PythonRobotics,1,2,1,2,3,3,2.0,4.754887502163469,0.5,2.3774437510817346,0.1320802083934297,0.0015849625007211565
311,PythonRobotics,1,2,1,2,3,3,2.0,4.754887502163469,0.5,2.3774437510817346,0.1320802083934297,0.0015849625007211565
312,PythonRobotics,1,2,1,2,3,3,2.0,4.754887502163469,0.5,2.3774437510817346,0.1320802083934297,0.0015849625007211565
313,PythonRobotics,0,0,0,0,0,0,0,0,0,0,0.0,0.0
314,PythonRobotics,1,2,1,2,3,3,2.0,4.754887502163469,0.5,2.3774437510817346,0.1320802083934297,0.0015849625007211565
315,PythonRobotics,1,2,1,2,3,3,2.0,4.754887502163469,0.5,2.3774437510817346,0.1320802083934297,0.0015849625007211565
316,PythonRobotics,1,2,1,2,3,3,2.0,4.754887502163469,0.5,2.3774437510817346,0.1320802083934297,0.0015849625007211565
317,PythonRobotics,1,2,1,2,3,3,2.0,4.754887502163469,0.5,2.3774437510817346,0.1320802083934297,0.0015849625007211565
318,PythonRobotics,3,13,7,14,16,21,52.860603837997665,84.0,1.6153846153846154,135.6923076923077,7.538461538461539,0.028
319,PythonRobotics,1,2,1,2,3,3,2.0,4.754887502163469,0.5,2.3774437510817346,0.1320802083934297,0.0015849625007211565
320,PythonRobotics,1,2,1,2,3,3,2.0,4.754887502163469,0.5,2.3774437510817346,0.1320802083934297,0.0015849625007211565
321,PythonRobotics,1,2,1,2,3,3,2.0,4.754887502163469,0.5,2.3774437510817346,0.1320802083934297,0.0015849625007211565
322,PythonRobotics,1,2,1,2,3,3,2.0,4.754887502163469,0.5,2.3774437510817346,0.1320802083934297,0.0015849625007211565
323,PythonRobotics,1,2,1,2,3,3,2.0,4.754887502163469,0.5,2.3774437510817346,0.1320802083934297,0.0015849625007211565
324,PythonRobotics,1,2,1,2,3,3,2.0,4.754887502163469,0.5,2.3774437510817346,0.1320802083934297,0.0015849625007211565
325,PythonRobotics,1,2,1,2,3,3,2.0,4.754887502163469,0.5,2.3774437510817346,0.1320802083934297,0.0015849625007211565
326,PythonRobotics,1,2,1,2,3,3,2.0,4.754887502163469,0.5,2.3774437510817346,0.1320802083934297,0.0015849625007211565
327,PythonRobotics,2,40,31,40,42,71,214.8771237954945,382.854537017292,1.0,382.854537017292,21.269696500960666,0.127618179005764
328,PythonRobotics,1,2,1,2,3,3,2.0,4.754887502163469,0.5,2.3774437510817346,0.1320802083934297,0.0015849625007211565
329,PythonRobotics,1,2,1,2,3,3,2.0,4.754887502163469,0.5,2.3774437510817346,0.1320802083934297,0.0015849625007211565
330,PythonRobotics,1,2,1,2,3,3,2.0,4.754887502163469,0.5,2.3774437510817346,0.1320802083934297,0.0015849625007211565
331,PythonRobotics,1,2,1,2,3,3,2.0,4.754887502163469,0.5,2.3774437510817346,0.1320802083934297,0.0015849625007211565
332,PythonRobotics,1,2,1,2,3,3,2.0,4.754887502163469,0.5,2.3774437510817346,0.1320802083934297,0.0015849625007211565
333,PythonRobotics,2,7,6,7,9,13,21.651484454403228,41.20902501875006,1.0,41.20902501875006,2.289390278819448,0.013736341672916687
334,PythonRobotics,1,2,1,2,3,3,2.0,4.754887502163469,0.5,2.3774437510817346,0.1320802083934297,0.0015849625007211565
335,PythonRobotics,1,2,1,2,3,3,2.0,4.754887502163469,0.5,2.3774437510817346,0.1320802083934297,0.0015849625007211565
336,PythonRobotics,1,2,1,2,3,3,2.0,4.754887502163469,0.5,2.3774437510817346,0.1320802083934297,0.0015849625007211565
337,PythonRobotics,3,20,11,22,23,33,91.19344939991072,149.27754454988144,1.65,246.30794850730436,13.683774917072464,0.04975918151662715
338,PythonRobotics,1,2,1,2,3,3,2.0,4.754887502163469,0.5,2.3774437510817346,0.1320802083934297,0.0015849625007211565
339,PythonRobotics,1,2,1,2,3,3,2.0,4.754887502163469,0.5,2.3774437510817346,0.1320802083934297,0.0015849625007211565
340,PythonRobotics,1,2,1,2,3,3,2.0,4.754887502163469,0.5,2.3774437510817346,0.1320802083934297,0.0015849625007211565
341,PythonRobotics,1,2,1,2,3,3,2.0,4.754887502163469,0.5,2.3774437510817346,0.1320802083934297,0.0015849625007211565
342,PythonRobotics,1,2,1,2,3,3,2.0,4.754887502163469,0.5,2.3774437510817346,0.1320802083934297,0.0015849625007211565
343,PythonRobotics,1,2,1,2,3,3,2.0,4.754887502163469,0.5,2.3774437510817346,0.1320802083934297,0.0015849625007211565
344,PythonRobotics,1,2,1,2,3,3,2.0,4.754887502163469,0.5,2.3774437510817346,0.1320802083934297,0.0015849625007211565
345,PythonRobotics,1,2,1,2,3,3,2.0,4.754887502163469,0.5,2.3774437510817346,0.1320802083934297,0.0015849625007211565
346,PythonRobotics,1,2,1,2,3,3,2.0,4.754887502163469,0.5,2.3774437510817346,0.1320802083934297,0.0015849625007211565
347,PythonRobotics,1,2,1,2,3,3,2.0,4.754887502163469,0.5,2.3774437510817346,0.1320802083934297,0.0015849625007211565
348,PythonRobotics,2,6,4,8,8,12,17.509775004326936,36.0,1.3333333333333333,48.0,2.6666666666666665,0.012
349,PythonRobotics,1,2,1,2,3,3,2.0,4.754887502163469,0.5,2.3774437510817346,0.1320802083934297,0.0015849625007211565
350,PythonRobotics,1,2,1,2,3,3,2.0,4.754887502163469,0.5,2.3774437510817346,0.1320802083934297,0.0015849625007211565
351,PythonRobotics,1,2,1,2,3,3,2.0,4.754887502163469,0.5,2.3774437510817346,0.1320802083934297,0.0015849625007211565
352,PythonRobotics,1,2,1,2,3,3,2.0,4.754887502163469,0.5,2.3774437510817346,0.1320802083934297,0.0015849625007211565
353,PythonRobotics,7,20,12,21,27,33,106.09004635215048,156.91128757139447,3.675,576.6489818248747,32.036054545826374,0.052303762523798154
354,PythonRobotics,1,2,1,2,3,3,2.0,4.754887502163469,0.5,2.3774437510817346,0.1320802083934297,0.0015849625007211565
355,PythonRobotics,4,12,7,13,16,20,51.01955000865388,80.0,2.1666666666666665,173.33333333333331,9.629629629629628,0.02666666666666667
356,PythonRobotics,1,2,1,2,3,3,2.0,4.754887502163469,0.5,2.3774437510817346,0.1320802083934297,0.0015849625007211565
357,PythonRobotics,1,2,1,2,3,3,2.0,4.754887502163469,0.5,2.3774437510817346,0.1320802083934297,0.0015849625007211565
358,PythonRobotics,6,61,39,77,67,116,377.284752595663,703.6663460931015,3.7868852459016393,2664.703704057483,148.03909466986016,0.2345554486977005
359,PythonRobotics,4,7,6,12,11,18,27.651484454403228,62.26976913547136,3.4285714285714284,213.49635132161606,11.860908406756447,0.020756589711823786
360,PythonRobotics,0,0,0,0,0,0,0,0,0,0,0.0,0.0
361,PythonRobotics,1,2,1,2,3,3,2.0,4.754887502163469,0.5,2.3774437510817346,0.1320802083934297,0.0015849625007211565
362,PythonRobotics,0,0,0,0,0,0,0,0,0,0,0.0,0.0
363,PythonRobotics,14,724,679,1286,738,1965,6931.191391157047,18721.49231690868,12.433701657458563,232777.45005084522,12932.08055838029,6.24049743896956
364,PythonRobotics,10,202,131,253,212,384,1580.1780004647362,2967.5214545522686,6.262376237623762,18583.73584162683,1032.4297689792684,0.9891738181840896
365,PythonRobotics,5,50,32,57,55,89,293.802449963173,514.5410145036948,2.85,1466.4418913355303,81.46899396308501,0.1715136715012316
366,PythonRobotics,0,0,0,0,0,0,0,0,0,0,0.0,0.0
367,PythonRobotics,2,13,16,32,15,48,50.105716335834195,187.53074858920888,2.4615384615384617,461.61415037343727,25.64523057630207,0.0625102495297363
368,PythonRobotics,0,0,0,0,0,0,0,0,0,0,0.0,0.0
369,PythonRobotics,0,0,0,0,0,0,0,0,0,0,0.0,0.0
370,PythonRobotics,9,155,122,232,164,354,1156.3286078304877,2604.573409634802,6.735483870967742,17543.062191346664,974.6145661859258,0.868191136544934
371,PythonRobotics,0,0,0,0,0,0,0,0,0,0,0.0,0.0
372,PythonRobotics,9,103,80,151,112,231,717.2388793128523,1572.4989869953065,6.597087378640777,10373.913220032144,576.328512224008,0.5241663289984355
373,PythonRobotics,8,84,66,124,92,190,560.9546635134159,1239.4767716508325,5.904761904761905,7318.8152230811065,406.60084572672815,0.4131589238836108
374,PythonRobotics,10,75,57,108,85,165,500.38068273606467,1057.549504462721,7.2,7614.356432131591,423.01980178508836,0.35251650148757363
375,PythonRobotics,10,47,36,66,57,102,294.2849569777226,594.9547814448038,7.0212765957446805,4177.342082484792,232.07456013804398,0.19831826048160126
376,PythonRobotics,0,0,0,0,0,0,0,0,0,0,0.0,0.0
377,PythonRobotics,0,0,0,0,0,0,0,0,0,0,0.0,0.0
378,PythonRobotics,14,213,205,329,227,534,1700.7961180169102,4179.3768922133495,10.812206572769954,45188.28630407204,2510.4603502262244,1.393125630737783
379,PythonRobotics,16,217,178,336,233,514,1748.2566174404521,4042.1916783522997,12.387096774193548,50071.01949958978,2781.723305532765,1.3473972261174332
380,PythonRobotics,16,81,63,109,97,172,577.5278502336546,1135.185008856186,10.765432098765432,12220.757132377705,678.9309517987614,0.37839500295206197
381,PythonRobotics,10,125,83,166,135,249,903.9423165316346,1762.1270836656572,6.64,11700.523835539963,650.0291019744424,0.5873756945552191
382,PythonRobotics,7,28,20,32,35,52,154.25742227201613,266.72271688113824,4.0,1066.890867524553,59.271714862475164,0.08890757229371275
383,PythonRobotics,0,0,0,0,0,0,0,0,0,0,0.0,0.0
384,PythonRobotics,5,36,25,50,41,75,197.72694052636004,401.81640034635626,3.4722222222222223,1395.1958345359592,77.51087969644217,0.1339388001154521
385,PythonRobotics,10,58,36,68,68,104,372.9821786662728,633.0961354900354,5.862068965517241,3711.253208045035,206.18073378027972,0.21103204516334514
386,PythonRobotics,6,22,15,26,28,41,113.61727061434748,197.10155180436175,3.5454545454545454,698.8145927609189,38.82303293116216,0.06570051726812058
387,PythonRobotics,14,69,53,96,83,149,474.7911564265002,949.8808752706918,9.73913043478261,9251.01374176674,513.94520787593,0.3166269584235639
388,PythonRobotics,0,0,0,0,0,0,0,0,0,0,0.0,0.0
389,PythonRobotics,12,74,56,103,86,159,502.51909906519626,1021.7760959976335,8.35135135135135,8533.211180088345,474.0672877826858,0.3405920319992112
390,PythonRobotics,17,161,116,209,178,325,1249.7644856777092,2429.613365064079,11.03416149068323,26808.746230039356,1489.374790557742,0.8098711216880263
391,PythonRobotics,9,73,45,84,82,129,480.38651781122206,820.124208595733,5.178082191780822,4246.670559577905,235.92614219877248,0.27337473619857766
392,PythonRobotics,12,184,123,236,196,359,1427.3549499231442,2733.6808340373595,7.695652173913044,21037.456853244028,1168.7476029580016,0.9112269446791198
393,PythonRobotics,14,77,58,100,91,158,535.8455325423139,1028.231553151394,9.090909090909092,9347.559574103583,519.3088652279769,0.3427438510504647
394,PythonRobotics,15,95,69,121,110,190,682.7396417255678,1288.4583455696854,9.552631578947368,12308.167880047258,683.7871044470699,0.42948611518989516
395,PythonRobotics,12,50,34,60,62,94,325.2123594973901,559.6944531763663,7.2,4029.800062869838,223.87778127054654,0.18656481772545544
396,PythonRobotics,14,106,88,168,120,256,766.4625370925055,1768.1639924757808,11.09433962264151,19616.611841052058,1089.8117689473365,0.5893879974919269
397,PythonRobotics,0,0,0,0,0,0,0,0,0,0,0.0,0.0
398,PythonRobotics,8,24,17,33,32,50,134.03910001730776,250.0,5.5,1375.0,76.38888888888889,0.08333333333333333
399,PythonRobotics,11,41,29,52,52,81,257.7133799943517,461.7356171694285,6.975609756097561,3220.887475864794,178.93819310359967,0.1539118723898095
400,PythonRobotics,13,71,55,93,84,148,484.7377618206666,946.0629785712565,8.514084507042254,8054.860148539783,447.4922304744324,0.3153543261904188
401,PythonRobotics,0,0,0,0,0,0,0,0,0,0,0.0,0.0
402,PythonRobotics,9,35,25,52,44,77,208.05423060605463,420.3762346350719,6.685714285714286,2810.515397274481,156.13974429302672,0.14012541154502398
403,PythonRobotics,11,62,48,90,73,138,407.2139190489966,854.1957891254424,7.983870967741935,6819.7889615660315,378.87716453144617,0.28473192970848077
404,PythonRobotics,13,329,286,562,342,848,2799.1852178947283,7138.338932623241,11.103343465045592,79259.42893882279,4403.3016077123775,2.3794463108744135
405,PythonRobotics,0,0,0,0,0,0,0,0,0,0,0.0,0.0
406,PythonRobotics,12,232,171,319,244,490,1866.0711408782504,3886.0612954058147,8.25,32060.00568709797,1781.1114270609985,1.2953537651352716
407,PythonRobotics,12,676,506,990,688,1496,6398.014048935411,14101.692073034339,8.78698224852071,123911.31791985795,6883.962106658775,4.7005640243447795
408,PythonRobotics,13,150,106,203,163,309,1132.4285199102162,2270.756999657403,8.796666666666667,19975.09240698629,1109.7273559436826,0.756918999885801
409,PythonRobotics,14,164,123,242,178,365,1259.9414976661724,2728.642702302735,10.329268292682928,28184.8825469563,1565.826808164239,0.909547567434245
410,PythonRobotics,17,102,77,134,119,211,750.0742531823482,1454.8065480579762,11.166666666666666,16245.3397866474,902.5188770359667,0.4849355160193254
411,PythonRobotics,14,106,103,162,120,265,766.4625370925055,1830.3260078362575,10.69811320754717,19581.034838550153,1087.8352688083419,0.6101086692787525
412,PythonRobotics,8,94,66,119,102,185,640.1313520576979,1234.3986882647266,5.0638297872340425,6250.784846957552,347.26582483097513,0.4114662294215755
413,PythonRobotics,8,76,53,105,84,158,498.84249102171253,1009.986152799044,5.526315789473684,5581.5024233631375,310.08346796461876,0.33666205093301466
414,PythonRobotics,11,38,26,43,49,69,237.47499331586653,387.4149792439494,6.223684210526316,2411.1484892419485,133.9526938467749,0.1291383264146498
415,PythonRobotics,0,0,0,0,0,0,0,0,0,0,0.0,0.0
416,PythonRobotics,11,41,28,45,52,73,257.7133799943517,416.1320994242998,6.036585365853658,2512.0169416466874,139.5564967581493,0.13871069980809994
417,PythonRobotics,9,64,45,84,73,129,412.5293250129808,798.4873680955222,5.90625,4716.066017814178,262.0036676563432,0.26616245603184074
418,PythonRobotics,11,71,49,95,82,144,474.6857932898427,915.4874886650042,7.359154929577465,6737.214265175559,374.2896813986422,0.3051624962216681
419,PythonRobotics,14,77,53,100,91,153,535.8455325423139,995.6925799504005,9.090909090909092,9051.750726821823,502.8750403789902,0.3318975266501335
420,PythonRobotics,0,0,0,0,0,0,0,0,0,0,0.0,0.0
421,PythonRobotics,15,89,59,114,104,173,634.9436342901372,1159.176071238409,9.606741573033707,11135.904954031905,618.6613863351058,0.3863920237461363
422,PythonRobotics,14,103,132,256,117,388,742.0125232086779,2665.701511198361,17.398058252427184,46378.03017541226,2576.557231967348,0.8885671703994537
423,PythonRobotics,0,0,0,0,0,0,0,0,0,0,0.0,0.0
424,PythonRobotics,14,150,113,223,164,336,1137.6257724831885,2472.1374735516765,10.406666666666666,25726.71064142778,1429.2617023015434,0.8240458245172255
425,PythonRobotics,7,143,138,219,150,357,1043.513085613713,2580.6882725070295,5.36013986013986,13832.850076060406,768.4916708922448,0.8602294241690098
426,PythonRobotics,18,276,169,331,294,500,2313.011400096736,4099.836172418181,10.793478260869565,44251.49260012232,2458.416255562351,1.3666120574727272
427,PythonRobotics,0,0,0,0,0,0,0,0,0,0,0.0,0.0
428,PythonRobotics,13,50,32,59,63,91,330.2985258245704,543.9324730384924,7.67,4171.962068205236,231.77567045584647,0.18131082434616413
429,PythonRobotics,15,76,60,101,91,161,533.4458499558403,1047.75493707199,9.967105263157896,10443.083747789902,580.1713193216613,0.34925164569066336
430,PythonRobotics,12,133,101,179,145,280,981.372113930312,2010.3745452041817,8.075187969924812,16234.152342475873,901.8973523597707,0.6701248484013939
431,PythonRobotics,0,0,0,0,0,0,0,0,0,0,0.0,0.0
432,PythonRobotics,10,123,92,174,133,266,887.1485651056,1876.7051278433164,7.073170731707317,13274.255782306385,737.458654572577,0.6255683759477721
433,PythonRobotics,2,8,8,9,10,17,26.0,56.472777613085164,1.125,63.53187481472081,3.5295486008178227,0.01882425920436172
434,PythonRobotics,13,95,74,141,108,215,672.2419991272743,1452.300812965146,9.647368421052631,14010.881000869012,778.3822778260562,0.484100270988382
435,PythonRobotics,15,75,51,97,90,148,525.7647607213188,960.7942582567919,9.7,9319.70430509088,517.7613502828267,0.32026475275226396
436,PythonRobotics,12,177,118,228,189,346,1364.7857323733444,2616.535878780491,7.728813559322034,20222.717978371253,1123.4843321317362,0.8721786262601637
437,PythonRobotics,16,79,61,106,95,167,561.9986791059912,1097.1658865912682,10.734177215189874,11777.173061131589,654.2873922850882,0.3657219621970894
438,PythonRobotics,12,125,94,166,137,260,913.7425855914148,1845.488341569737,7.968,14704.851105627664,816.9361725348703,0.6151627805232457
439,PythonRobotics,6,34,22,44,40,66,188.4835116068385,351.24725426256595,3.8823529411764706,1363.6658106664324,75.7592117036907,0.11708241808752198
440,PythonRobotics,10,36,29,44,46,73,219.33658100079685,403.22002279216196,6.111111111111111,2464.122361507656,136.89568675042534,0.13440667426405398
441,PythonRobotics,13,155,116,204,168,320,1175.9049991533411,2365.5415752892036,8.55483870967742,20236.82663763538,1124.268146535299,0.7885138584297345
442,PythonRobotics,11,35,25,41,46,66,217.5786533980841,364.5550890997629,6.442857142857143,2348.7763597713297,130.48757554285166,0.12151836303325429
443,PythonRobotics,10,101,72,131,111,203,705.6986407068049,1379.2664208690715,6.485148514851486,8944.747580883582,496.93042116019905,0.4597554736230238
444,PythonRobotics,0,0,0,0,0,0,0,0,0,0,0.0,0.0
445,PythonRobotics,12,87,61,106,99,167,603.5556341474933,1107.1025555532947,7.310344827586207,8093.3014405965,449.6278578109166,0.36903418518443154
446,PythonRobotics,0,0,0,0,0,0,0,0,0,0,0.0,0.0
447,PythonRobotics,11,134,80,158,145,238,984.9096993263518,1708.8183634235545,6.485074626865671,11081.814610560215,615.6563672533453,0.5696061211411848
448,PythonRobotics,8,115,77,154,123,231,811.2313558586033,1603.7208507333644,5.356521739130435,8590.36560045002,477.24253335833447,0.5345736169111215
449,PythonRobotics,9,117,72,143,126,215,832.3619972042392,1500.115183552482,5.5,8250.633509538651,458.36852830770283,0.500038394517494
450,PythonRobotics,13,102,66,127,115,193,728.6931012169267,1321.1795798322646,8.093137254901961,10692.48767795622,594.02709321979,0.44039319327742155
451,PythonRobotics,8,80,48,95,88,143,529.7542475909889,923.6987214651336,4.75,4387.568926959385,243.75382927552138,0.30789957382171124
452,PythonRobotics,12,124,75,148,136,223,905.3398924966266,1580.5042135988258,7.161290322580645,11318.449529643203,628.8027516468446,0.5268347378662752
453,PythonRobotics,0,0,0,0,0,0,0,0,0,0,0.0,0.0
454,PythonRobotics,15,110,89,172,125,261,804.5529274218403,1818.069698296805,11.727272727272727,21320.999189117076,1184.4999549509487,0.6060232327656017
455,PythonRobotics,15,102,83,162,117,245,739.1907438152202,1683.2393562979341,11.911764705882353,20050.351155901863,1113.9083975501035,0.5610797854326447
456,PythonRobotics,7,56,49,78,63,127,344.86336008962905,759.1145502844894,4.875,3700.6834326368858,205.59352403538253,0.25303818342816314
457,PythonRobotics,6,13,20,31,19,51,63.61549134016113,216.64430318562285,7.153846153846154,1549.8400150971481,86.10222306095267,0.07221476772854095
458,PythonRobotics,0,0,0,0,0,0,0,0,0,0,0.0,0.0
459,PythonRobotics,6,13,15,26,19,41,63.61549134016113,174.165028051187,6.0,1044.990168307122,58.05500935039567,0.05805500935039566
460,PythonRobotics,0,0,0,0,0,0,0,0,0,0,0.0,0.0
461,PythonRobotics,12,92,58,112,104,170,643.1872499658991,1139.0747520839857,7.304347826086956,8320.198189135199,462.2332327297333,0.37969158402799524
462,PythonRobotics,7,20,18,34,27,52,106.09004635215048,247.25415011250038,5.95,1471.1621931693774,81.7312329538543,0.08241805003750013
463,PythonRobotics,12,82,61,119,94,180,564.3388143873369,1179.8259933019747,8.707317073170731,10273.1190148489,570.7288341582722,0.3932753311006582
464,PythonRobotics,14,144,93,173,158,266,1085.7721691164995,1942.8056790151095,8.409722222222221,16338.456092272898,907.6920051262721,0.6476018930050365
465,SqueezeSeg,15,243,183,347,258,530,1984.3327973103326,4245.950445374325,10.709876543209877,45473.60507854601,2526.311393252556,1.415316815124775
466,SqueezeSeg,0,0,0,0,0,0,0,0,0,0,0.0,0.0
