,Repository,h1,h2,N1,N2,vocabulary,length,calculated_length,volume,difficulty,effort,time,bugs
0,self-driving-car-using-ros,2,4,2,4,6,6,10.0,15.509775004326936,1.0,15.509775004326936,0.861654166907052,0.005169925001442312
1,self-driving-car-using-ros,0,0,0,0,0,0,0,0,0,0,0.0,0.0
2,self-driving-car-using-ros,5,24,14,28,29,42,121.64874049174458,204.03520179535806,2.9166666666666665,595.1026719031277,33.06125955017376,0.06801173393178601
3,self-driving-car-using-ros,7,20,18,33,27,51,106.09004635215048,242.49926261033693,5.775,1400.4332415746958,77.80184675414976,0.08083308753677898
4,self-driving-car-using-ros,4,15,8,15,19,23,66.60335893412778,97.70233280920246,2.0,195.40466561840492,10.85581475657805,0.03256744426973415
5,self-driving-car-using-ros,3,14,10,20,17,30,58.05785641096992,122.6238852375102,2.142857142857143,262.7654683660933,14.59808157589407,0.040874628412503396
6,self-driving-car-using-ros,6,18,11,22,24,33,90.56842503028855,151.30376252379818,3.6666666666666665,554.78046258726,30.82113681040333,0.05043458750793273
7,self-driving-car-using-ros,4,17,11,20,21,31,77.48686830125578,136.16184010614157,2.3529411764705883,320.3808002497449,17.79893334720805,0.04538728003538052
8,self-driving-car-using-ros,3,4,3,4,7,7,12.75488750216347,19.651484454403228,1.5,29.47722668160484,1.6376237045336022,0.00655049481813441
9,self-driving-car-using-ros,6,17,11,21,23,32,84.99664330558272,144.75398259382442,3.7058823529411766,536.4412296124082,29.802290534022674,0.048251327531274806
10,self-driving-car-using-ros,14,51,32,60,65,92,342.59666134935276,554.0578387986178,8.235294117647058,4562.829260694499,253.4905144830277,0.18468594626620594
11,self-driving-car-using-ros,2,3,2,3,5,5,6.754887502163469,11.60964047443681,1.0,11.60964047443681,0.6449800263576005,0.0038698801581456034
12,self-driving-car-using-ros,4,7,4,7,11,11,27.651484454403228,38.053747805010275,2.0,76.10749561002055,4.228194200556697,0.012684582601670092
13,self-driving-car-using-ros,0,0,0,0,0,0,0,0,0,0,0.0,0.0
14,self-driving-car-using-ros,13,27,20,33,40,53,176.48767889424786,282.0621890290302,7.944444444444445,2240.8273906195177,124.49041058997321,0.09402072967634341
15,self-driving-car-using-ros,4,10,6,11,14,17,41.219280948873624,64.72503367497926,2.2,142.3950740849544,7.9108374491641325,0.021575011224993085
16,self-driving-car-using-ros,0,0,0,0,0,0,0,0,0,0,0.0,0.0
17,self-driving-car-using-ros,8,26,15,30,34,45,146.2114326716684,228.9358278562653,4.615384615384615,1056.6268977981474,58.7014943221193,0.0763119426187551
18,self-driving-car-using-ros,6,39,28,56,45,84,221.64046153995463,461.3156600916927,4.3076923076923075,1987.2059203949837,110.40032891083243,0.15377188669723088
19,self-driving-car-using-ros,0,0,0,0,0,0,0,0,0,0,0.0,0.0
20,self-driving-car-using-ros,10,69,52,101,79,153,454.7074684665674,964.4784544710968,7.318840579710145,7058.864050839186,392.15911393551033,0.3214928181570323
21,self-driving-car-using-ros,0,0,0,0,0,0,0,0,0,0,0.0,0.0
22,self-driving-car-using-ros,11,178,130,240,189,370,1368.7342985170292,2798.029696961797,7.415730337078652,20749.433707806587,1152.746317100366,0.9326765656539323
23,self-driving-car-using-ros,3,5,3,6,8,9,16.36452797660028,27.0,1.8,48.6,2.7,0.009
24,self-driving-car-using-ros,1,5,9,9,6,18,11.60964047443681,46.529325012980806,0.9,41.876392511682724,2.32646625064904,0.015509775004326935
25,self-driving-car-using-ros,12,160,116,182,172,298,1214.5280451906317,2213.026896901225,6.825,15103.908571350861,839.1060317417146,0.7376756323004083
26,self-driving-car-using-ros,6,10,6,12,16,18,48.72905595320056,72.0,3.6,259.2,14.399999999999999,0.024
27,self-driving-car-using-ros,0,0,0,0,0,0,0,0,0,0,0.0,0.0
28,self-driving-car-using-ros,3,11,6,12,14,18,42.808635307173745,68.53238859703687,1.6363636363636365,112.14390861333307,6.23021714518517,0.022844129532345624
29,self-driving-car-using-ros,15,233,191,381,248,572,1890.958730638575,4549.800289541293,12.263948497854077,55798.516426455986,3099.917579247555,1.5166000965137643
30,self-driving-car-using-ros,0,0,0,0,0,0,0,0,0,0,0.0,0.0
31,self-driving-car-using-ros,11,52,37,68,63,105,334.4766131483471,627.6143919674913,7.1923076923076925,4513.995819150803,250.77754550837795,0.2092047973224971
32,self-driving-car-using-ros,18,261,197,377,279,574,2170.3421151307016,4663.245632989953,13.0,60622.19322886939,3367.8996238260775,1.5544152109966511
33,self-driving-car-using-ros,6,59,45,73,65,118,362.58571491667556,710.6394019373577,3.711864406779661,2637.797102106463,146.54428345035907,0.2368798006457859
34,self-driving-car-using-ros,5,23,15,30,28,45,115.65156546374811,216.33097149259217,3.260869565217391,705.4270809541049,39.19039338633916,0.07211032383086406
35,self-driving-car-using-ros,0,0,0,0,0,0,0,0,0,0,0.0,0.0
36,self-driving-car-using-ros,11,55,36,63,66,99,356.02853204886657,598.3950178164869,6.3,3769.888612243867,209.43825623577038,0.19946500593882896
37,self-driving-car-using-ros,17,156,119,219,173,338,1206.0096144437666,2512.9043409412134,11.932692307692308,29985.714299115825,1665.8730166175458,0.8376347803137378
38,self-driving-car-using-ros,9,314,255,460,323,715,2633.0402401649512,5959.804103606156,6.592356687898089,39289.15444097052,2182.73080227614,1.9866013678687187
39,self-driving-car-using-ros,14,265,271,495,279,766,2186.5128345132057,6223.076924861157,13.075471698113208,81369.66620620343,4520.537011455746,2.074358974953719
40,self-driving-car-using-ros,8,32,24,46,40,70,184.0,372.53496664211536,5.75,2142.076058192163,119.00422545512018,0.12417832221403846
41,self-driving-car-using-ros,3,21,24,48,24,72,96.99355338051744,330.1173000519233,3.4285714285714284,1131.8307430351654,62.87948572417585,0.11003910001730775
42,self-driving-car-using-ros,0,0,0,0,0,0,0,0,0,0,0.0,0.0
43,self-driving-car-using-ros,16,103,73,135,119,208,752.7095542998715,1434.1220947680522,10.485436893203884,15037.396721839772,835.4109289910984,0.4780406982560174
44,self-driving-car-using-ros,9,27,17,34,36,51,156.9112875713945,263.6661750735579,5.666666666666667,1494.1083254168282,83.00601807871267,0.0878887250245193
45,self-driving-car-using-ros,17,103,73,138,120,211,758.1964226011272,1457.3539156733975,11.388349514563107,16596.85575810578,922.0475421169878,0.4857846385577992
46,self-driving-car-using-ros,7,40,29,53,47,82,232.52860824989773,455.4762858375663,4.6375,2112.271275571714,117.34840419842855,0.1518254286125221
47,self-driving-car-using-ros,9,33,21,39,42,60,194.9943309518098,323.53904536672565,5.318181818181818,1720.6394685412229,95.5910815856235,0.10784634845557521
48,self-driving-car-using-ros,8,27,15,29,35,44,152.38196255841368,225.68845274557853,4.296296296296297,969.6244636476708,53.868025758203935,0.07522948424852617
49,self-driving-car-using-ros,8,46,64,121,54,185,278.0838499786226,1064.6541879002418,10.521739130434783,11202.01362921124,622.3340905117356,0.3548847293000806
50,self-driving-car-using-ros,12,162,133,251,174,384,1232.075250475963,2858.0903024059116,9.296296296296296,26569.654292736435,1476.091905152024,0.9526967674686372
51,self-driving-car-using-ros,3,5,4,8,8,12,16.36452797660028,36.0,2.4,86.39999999999999,4.8,0.012
52,self-driving-car-using-ros,1,2,1,2,3,3,2.0,4.754887502163469,0.5,2.3774437510817346,0.1320802083934297,0.0015849625007211565
53,self-driving-car-using-ros,0,0,0,0,0,0,0,0,0,0,0.0,0.0
54,self-driving-car-using-ros,6,18,15,26,24,41,90.56842503028855,187.98346252956745,4.333333333333333,814.5950042947923,45.255278016377346,0.06266115417652249
55,self-driving-car-using-ros,4,11,10,19,15,29,46.053747805010275,113.29982727264704,3.4545454545454546,391.399403305508,21.744411294750442,0.03776660909088234
56,self-driving-car-using-ros,8,17,14,25,25,39,93.48686830125578,181.11039140121426,5.882352941176471,1065.3552435365546,59.186402418697476,0.06037013046707142
57,self-driving-car-using-ros,1,2,1,2,3,3,2.0,4.754887502163469,0.5,2.3774437510817346,0.1320802083934297,0.0015849625007211565
58,self-driving-car-using-ros,4,9,8,16,13,24,36.52932501298081,88.81055323538621,3.5555555555555554,315.7708559480398,17.542825330446657,0.029603517745128736
59,self-driving-car-using-ros,0,0,0,0,0,0,0,0,0,0,0.0,0.0
60,self-driving-car-using-ros,13,193,124,250,206,374,1513.4499245285738,2874.7511971665235,8.419689119170984,24204.51137510674,1344.695076394819,0.9582503990555078
61,self-driving-car-using-ros,1,4,4,8,5,12,8.0,27.863137138648348,1.0,27.863137138648348,1.5479520632582415,0.00928771237954945
62,self-driving-car-using-ros,0,0,0,0,0,0,0,0,0,0,0.0,0.0
63,self-driving-car-using-ros,18,244,162,307,262,469,2010.158560391306,3767.675387721064,11.323770491803279,42664.29137816926,2370.2384098982925,1.2558917959070213
64,self-driving-car-using-ros,7,23,20,39,30,59,123.69340944371453,289.50654514090263,5.934782608695652,1718.1584092057917,95.45324495587732,0.09650218171363421
65,self-driving-car-using-ros,13,77,54,103,90,157,530.6482799693416,1019.220936123759,8.694805194805195,8861.927490063073,492.3293050035041,0.339740312041253
66,self-driving-car-using-ros,17,170,145,290,187,435,1329.0833274446652,3282.899090051122,14.5,47602.03680574127,2644.5576003189594,1.0942996966837073
67,self-driving-car-using-ros,0,0,0,0,0,0,0,0,0,0,0.0,0.0
68,self-driving-car-using-ros,12,104,74,144,116,218,739.8652806953273,1495.0398569378106,8.307692307692308,12420.331119175658,690.0183955097588,0.4983466189792702
69,self-driving-car-using-ros,10,107,72,128,117,200,754.5562484937963,1374.072943916681,5.981308411214953,8218.754057071736,456.5974476150964,0.45802431463889365
70,self-driving-car-using-ros,12,34,23,43,46,66,215.99328661116544,364.5550890997629,7.588235294117647,2766.329793757024,153.68498854205689,0.12151836303325429
71,self-driving-car-using-ros,9,29,25,50,38,75,169.41077387168042,393.5945635082689,7.758620689655173,3053.750923771052,169.65282909839178,0.13119818783608964
72,self-driving-car-using-ros,12,34,23,43,46,66,215.99328661116544,364.5550890997629,7.588235294117647,2766.329793757024,153.68498854205689,0.12151836303325429
73,self-driving-car-using-ros,4,10,6,10,14,16,41.219280948873624,60.91767875292166,2.0,121.83535750584332,6.768630972546851,0.020305892917640553
74,self-driving-car-using-ros,7,13,10,18,20,28,67.75720079023742,121.01398665684616,4.846153846153846,586.4523968754852,32.58068871530473,0.040337995552282055
75,self-driving-car-using-ros,4,18,12,21,22,33,83.05865002596161,147.1612434150308,2.3333333333333335,343.3762346350719,19.076457479726216,0.04905374780501027
76,self-driving-car-using-ros,21,693,501,953,714,1454,6631.879764579444,13783.60050389831,14.43939393939394,199026.8375790165,11057.046532167582,4.594533501299437
77,self-driving-car-using-ros,19,609,434,813,628,1247,5714.142359260384,11590.39207386786,12.682266009852217,146992.4354392749,8166.246413293051,3.8634640246226204
78,self-driving-car-using-ros,3,11,6,12,14,18,42.808635307173745,68.53238859703687,1.6363636363636365,112.14390861333307,6.23021714518517,0.022844129532345624
79,self-driving-car-using-ros,18,814,573,1116,832,1689,7945.531027218687,16384.042683940304,12.339066339066338,202163.7895792339,11231.321643290772,5.461347561313435
80,self-driving-car-using-ros,10,53,38,74,63,112,336.79906504072324,669.4553514319907,6.981132075471698,4673.5562269780485,259.6420126098916,0.22315178381066358
81,self-driving-car-using-ros,13,170,125,238,183,363,1307.7021754792436,2728.1990412971077,9.1,24826.61127580368,1379.2561819890934,0.9093996804323692
82,self-driving-car-using-ros,10,56,41,81,66,122,358.4311565840995,737.4160825617313,7.232142857142857,5333.098454241092,296.28324745783846,0.24580536085391042
83,self-driving-car-using-ros,0,0,0,0,0,0,0,0,0,0,0.0,0.0
84,self-driving-car-using-ros,13,68,52,101,81,153,462.0531895408573,969.9970504413477,9.654411764705882,9364.750935510952,520.2639408617196,0.3233323501471159
85,self-driving-car-using-ros,9,36,25,49,45,74,214.64662506490404,406.39712912839593,6.125,2489.182415911425,138.28791199507916,0.1354657097094653
86,self-driving-car-using-ros,8,23,16,31,31,47,128.0419249893113,232.84722658818316,5.391304347826087,1255.3502650841178,69.7416813935621,0.07761574219606106
87,self-driving-car-using-ros,8,23,16,31,31,47,128.0419249893113,232.84722658818316,5.391304347826087,1255.3502650841178,69.7416813935621,0.07761574219606106
88,self-driving-car-using-ros,9,35,26,51,44,77,208.05423060605463,420.3762346350719,6.557142857142857,2756.4670242499715,153.13705690277618,0.14012541154502398
89,self-driving-car-using-ros,14,120,114,217,134,331,882.1298403818287,2338.8755220415223,12.658333333333333,29606.265983175603,1644.792554620867,0.7796251740138408
90,self-driving-car-using-ros,9,62,46,91,71,137,397.6894962569671,842.5153553721415,6.604838709677419,5564.678032659547,309.14877959219706,0.2808384517907138
91,self-driving-car-using-ros,14,90,59,110,104,169,637.5697475784772,1132.3743123658446,8.555555555555555,9688.091339130004,538.2272966183335,0.3774581041219482
92,self-driving-car-using-ros,0,0,0,0,0,0,0,0,0,0,0.0,0.0
93,self-driving-car-using-ros,15,70,49,95,85,144,487.6531701202755,922.9522948038292,10.178571428571429,9394.33585782469,521.9075476569272,0.30765076493460974
94,self-driving-car-using-ros,18,299,220,415,317,635,2534.035150611195,5275.795284138524,12.491638795986622,65903.32905102805,3661.2960583904473,1.7585984280461746
95,self-driving-car-using-ros,0,0,0,0,0,0,0,0,0,0,0.0,0.0
96,self-driving-car-using-ros,18,875,587,1116,893,1703,8626.55545590569,16693.685369801442,11.478857142857143,191624.42954775508,10645.801641541948,5.564561789933814
97,self-driving-car-using-ros,19,817,579,1110,836,1689,7984.525705830452,16395.729574084613,12.906976744186046,211619.3003166735,11756.62779537075,5.465243191361537
98,self-driving-car-using-ros,16,252,172,331,268,503,2074.274540721979,4057.2428628002594,10.507936507936508,42633.25039958368,2368.5139110879823,1.3524142876000864
99,COLA,15,153,121,236,168,357,1168.9836988661036,2639.0573199320174,11.568627450980392,30530.270956076278,1696.1261642264599,0.8796857733106724
100,COLA,13,98,65,121,111,186,696.3472810591247,1263.7613511411198,8.025510204081632,10142.329619107048,563.4627566170582,0.4212537837137066
101,COLA,10,96,62,111,106,173,665.3756810181046,1163.9302386394334,5.78125,6728.971692134224,373.8317606741236,0.38797674621314443
102,COLA,15,117,82,156,132,238,862.4360311253861,1676.5658004073118,10.0,16765.658004073117,931.4254446707287,0.5588552668024372
103,COLA,14,120,93,180,134,273,882.1298403818287,1929.0423489949717,10.5,20254.944664447205,1125.2747035804002,0.6430141163316573
104,COLA,12,88,55,102,100,157,611.4495324487361,1043.0854217946319,6.954545454545454,7254.184978844485,403.0102766024714,0.3476951405982106
105,COLA,4,34,32,44,38,76,180.97373660251156,398.8424910217125,2.588235294117647,1032.2982120561971,57.34990066978873,0.1329474970072375
106,COLA,21,298,217,390,319,607,2541.550884976078,5048.669456555275,13.741610738255034,69376.85041810018,3854.269467672232,1.6828898188517585
107,COLA,11,140,92,182,151,274,1036.1533701773055,1983.3228985750718,7.15,14180.758724811763,787.8199291562091,0.6611076328583573
108,COLA,0,0,0,0,0,0,0,0,0,0,0.0,0.0
109,COLA,0,0,0,0,0,0,0,0,0,0,0.0,0.0
110,COLA,3,14,19,33,17,52,58.05785641096992,212.54806774501768,3.5357142857142856,751.5092395270268,41.75051330705705,0.0708493559150059
111,COLA,2,4,2,4,6,6,10.0,15.509775004326936,1.0,15.509775004326936,0.861654166907052,0.005169925001442312
112,COLA,12,54,33,66,66,99,353.78347512548123,598.3950178164869,7.333333333333333,4388.230130654237,243.79056281412426,0.19946500593882896
113,COLA,0,0,0,0,0,0,0,0,0,0,0.0,0.0
114,COLA,3,16,12,23,19,35,68.75488750216347,148.67746297052548,2.15625,320.58577953019557,17.810321085010866,0.04955915432350849
115,COLA,5,17,12,22,22,34,81.0965087756926,151.6206750336681,3.235294117647059,490.5374780501027,27.252082113894595,0.050540225011222704
116,COLA,0,0,0,0,0,0,0,0,0,0,0.0,0.0
117,COLA,0,0,0,0,0,0,0,0,0,0,0.0,0.0
118,GAIS-Net,5,14,7,14,19,21,64.91260938324326,89.20647778231529,2.5,223.01619445578822,12.389788580877124,0.029735492594105097
119,GAIS-Net,5,15,8,16,20,24,70.2129994085646,103.72627427729671,2.6666666666666665,276.6033980727912,15.366855448488401,0.0345754247590989
120,GAIS-Net,6,19,11,21,25,32,96.22039775975506,148.60339807279118,3.3157894736842106,492.7375830834655,27.374310171303637,0.04953446602426373
121,GAIS-Net,7,23,13,25,30,38,123.69340944371453,186.46184263312372,3.8043478260869565,709.3657056694924,39.40920587052736,0.062153947544374574
122,GAIS-Net,7,12,8,14,19,22,62.67103446305711,93.45440529575887,4.083333333333333,381.6054882910154,21.20030490505641,0.031151468431919623
123,GAIS-Net,9,65,40,78,74,118,419.9832328598303,732.7154971442162,5.4,3956.663684578768,219.8146491432649,0.24423849904807207
124,GAIS-Net,0,0,0,0,0,0,0,0,0,0,0.0,0.0
125,GAIS-Net,12,87,69,133,99,202,603.5556341474933,1339.130037256081,9.172413793103448,12283.054824486813,682.3919346937118,0.4463766790853604
126,GAIS-Net,1,13,8,16,14,24,48.105716335834195,91.37651812938249,0.6153846153846154,56.23170346423538,3.1239835257908544,0.03045883937646083
127,GAIS-Net,0,0,0,0,0,0,0,0,0,0,0.0,0.0
128,GAIS-Net,0,0,0,0,0,0,0,0,0,0,0.0,0.0
129,GAIS-Net,1,10,6,12,11,18,33.219280948873624,62.26976913547136,0.6,37.361861481282816,2.0756589711823787,0.020756589711823786
130,GAIS-Net,8,35,24,47,43,71,203.5249055930738,385.264797583849,5.371428571428571,2069.4223413075315,114.96790785041841,0.12842159919461632
131,GAIS-Net,5,11,8,14,16,22,49.663388279447084,88.0,3.1818181818181817,280.0,15.555555555555555,0.029333333333333333
132,GAIS-Net,3,6,3,6,9,9,20.264662506490406,28.529325012980813,1.5,42.793987519471216,2.377443751081734,0.009509775004326938
133,GAIS-Net,5,9,7,14,14,21,40.13896548741762,79.95445336320968,3.888888888888889,310.93398530137097,17.27411029452061,0.026651484454403226
134,GAIS-Net,4,8,6,10,12,16,32.0,57.359400011538504,2.5,143.39850002884626,7.966583334935903,0.01911980000384617
135,GAIS-Net,0,0,0,0,0,0,0,0,0,0,0.0,0.0
136,GAIS-Net,12,66,46,87,78,133,441.9495618863118,835.9584951086791,7.909090909090909,6611.671734041372,367.3150963356318,0.27865283170289307
137,GAIS-Net,5,19,25,41,24,66,92.32026322986493,302.60752504759637,5.394736842105263,1632.4879640725592,90.69377578180884,0.10086917501586545
138,GAIS-Net,8,21,18,33,29,51,116.23866587835397,247.75703075150622,6.285714285714286,1557.3299075808961,86.51832819893868,0.08258567691716874
139,GAIS-Net,14,112,87,173,126,260,815.726720179258,1814.0927801099783,10.8125,19614.87818493914,1089.715454718841,0.6046975933699927
140,GAIS-Net,10,26,16,32,36,48,155.43071362054204,248.15640006923098,6.153846153846154,1527.1163081183447,84.8397948954636,0.082718800023077
141,GAIS-Net,11,55,38,75,66,113,356.02853204886657,683.0165354875053,7.5,5122.624016156289,284.59022311979385,0.2276721784958351
142,GAIS-Net,0,0,0,0,0,0,0,0,0,0,0.0,0.0
143,GAIS-Net,13,117,78,141,130,219,851.9383885270926,1537.8985510532316,7.833333333333333,12046.871983250314,669.2706657361285,0.5126328503510772
144,GAIS-Net,7,16,12,22,23,34,83.65148445440323,153.80110650593844,4.8125,740.1678250598287,41.12043472554604,0.05126703550197948
145,GAIS-Net,0,0,0,0,0,0,0,0,0,0,0.0,0.0
146,GAIS-Net,1,6,4,8,7,12,15.509775004326936,33.68825906469125,0.6666666666666666,22.458839376460833,1.2477132986922685,0.011229419688230418
147,GAIS-Net,3,5,6,11,8,17,16.36452797660028,51.0,3.3,168.29999999999998,9.35,0.017
148,GAIS-Net,3,9,5,10,12,15,33.28421251514428,53.77443751081735,1.6666666666666667,89.62406251802892,4.9791145843349405,0.017924812503605784
149,GAIS-Net,1,2,1,2,3,3,2.0,4.754887502163469,0.5,2.3774437510817346,0.1320802083934297,0.0015849625007211565
150,GAIS-Net,6,15,11,19,21,30,74.11313393845472,131.76952268336282,3.8,500.7241861967787,27.818010344265485,0.04392317422778761
151,GAIS-Net,7,21,15,24,28,39,111.8901503327572,187.48684196024655,4.0,749.9473678409862,41.663742657832564,0.06249561398674885
152,GAIS-Net,7,14,10,18,21,28,72.95445336320968,122.9848878378053,4.5,553.4319952701238,30.746221959451322,0.04099496261260177
153,GAIS-Net,2,4,2,4,6,6,10.0,15.509775004326936,1.0,15.509775004326936,0.861654166907052,0.005169925001442312
154,GAIS-Net,6,11,7,12,17,19,53.563522809337215,77.66179398375645,3.272727272727273,254.16587121956658,14.12032617886481,0.02588726466125215
155,GAIS-Net,1,2,1,2,3,3,2.0,4.754887502163469,0.5,2.3774437510817346,0.1320802083934297,0.0015849625007211565
156,GAIS-Net,4,9,5,10,13,15,36.52932501298081,55.506595772116384,2.2222222222222223,123.34799060470309,6.852666144705727,0.01850219859070546
157,GAIS-Net,0,0,0,0,0,0,0,0,0,0,0.0,0.0
158,GAIS-Net,1,2,1,2,3,3,2.0,4.754887502163469,0.5,2.3774437510817346,0.1320802083934297,0.0015849625007211565
159,GAIS-Net,0,0,0,0,0,0,0,0,0,0,0.0,0.0
160,GAIS-Net,0,0,0,0,0,0,0,0,0,0,0.0,0.0
161,GAIS-Net,3,6,5,7,9,12,20.264662506490406,38.03910001730775,1.75,66.56842503028857,3.6982458350160314,0.012679700005769252
162,GAIS-Net,1,2,1,2,3,3,2.0,4.754887502163469,0.5,2.3774437510817346,0.1320802083934297,0.0015849625007211565
163,GAIS-Net,4,9,6,11,13,17,36.52932501298081,62.907475208398566,2.4444444444444446,153.7738282871965,8.542990460399805,0.02096915840279952
164,GAIS-Net,9,21,13,25,30,38,120.76799089133479,186.46184263312372,5.357142857142857,998.9027283917342,55.49459602176301,0.062153947544374574
165,GAIS-Net,0,0,0,0,0,0,0,0,0,0,0.0,0.0
166,GAIS-Net,5,15,9,15,20,24,70.2129994085646,103.72627427729671,2.5,259.3156856932418,14.406426982957877,0.0345754247590989
167,GAIS-Net,6,14,10,18,20,28,68.81274391313339,121.01398665684616,3.857142857142857,466.7682342478352,25.931568569324178,0.040337995552282055
168,GAIS-Net,0,0,0,0,0,0,0,0,0,0,0.0,0.0
169,GAIS-Net,4,85,54,108,89,162,552.7982295717047,1049.0688158165565,2.541176470588235,2665.868990780896,148.1038328211609,0.3496896052721855
170,GAIS-Net,0,0,0,0,0,0,0,0,0,0,0.0,0.0
171,GAIS-Net,1,2,1,2,3,3,2.0,4.754887502163469,0.5,2.3774437510817346,0.1320802083934297,0.0015849625007211565
172,GAIS-Net,9,26,21,38,35,59,150.74075768464922,302.627697999753,6.576923076923077,1990.3590906906832,110.57550503837129,0.10087589933325102
173,GAIS-Net,4,6,4,8,10,12,23.509775004326936,39.863137138648355,2.6666666666666665,106.3016990363956,5.905649946466422,0.013287712379549451
174,GAIS-Net,1,2,2,4,3,6,2.0,9.509775004326938,1.0,9.509775004326938,0.5283208335737188,0.003169925001442313
175,GAIS-Net,0,0,0,0,0,0,0,0,0,0,0.0,0.0
176,GAIS-Net,6,14,10,17,20,27,68.81274391313339,116.69205856195879,3.642857142857143,425.09249904713556,23.616249947063086,0.03889735285398626
177,GAIS-Net,12,87,60,112,99,172,603.5556341474933,1140.2493386536928,7.724137931034483,8807.443167531972,489.3023981962207,0.38008311288456426
178,GAIS-Net,2,6,6,8,8,14,17.509775004326936,42.0,1.3333333333333333,56.0,3.111111111111111,0.014
179,GAIS-Net,7,17,15,23,24,38,89.13835275565901,174.22857502740396,4.735294117647059,825.0235464532952,45.83464146962751,0.058076191675801324
180,GAIS-Net,0,0,0,0,0,0,0,0,0,0,0.0,0.0
181,GAIS-Net,4,10,5,10,14,15,41.219280948873624,57.110323830864054,2.0,114.22064766172811,6.345591536762672,0.019036774610288017
182,GAIS-Net,9,22,19,31,31,50,126.63682062300134,247.70981551934378,6.340909090909091,1570.7054211340208,87.26141228522337,0.08256993850644792
183,GAIS-Net,4,10,7,13,14,20,41.219280948873624,76.14709844115208,2.6,197.98245594699543,10.999025330388635,0.025382366147050694
184,GAIS-Net,4,9,5,10,13,15,36.52932501298081,55.506595772116384,2.2222222222222223,123.34799060470309,6.852666144705727,0.01850219859070546
185,GAIS-Net,4,9,5,10,13,15,36.52932501298081,55.506595772116384,2.2222222222222223,123.34799060470309,6.852666144705727,0.01850219859070546
186,GAIS-Net,4,11,6,12,15,18,46.053747805010275,70.32403072095333,2.1818181818181817,153.43424884571635,8.52412493587313,0.02344134357365111
187,GAIS-Net,2,4,2,4,6,6,10.0,15.509775004326936,1.0,15.509775004326936,0.861654166907052,0.005169925001442312
188,GAIS-Net,0,0,0,0,0,0,0,0,0,0,0.0,0.0
189,GAIS-Net,0,0,0,0,0,0,0,0,0,0,0.0,0.0
190,GAIS-Net,4,9,5,10,13,15,36.52932501298081,55.506595772116384,2.2222222222222223,123.34799060470309,6.852666144705727,0.01850219859070546
191,GAIS-Net,0,0,0,0,0,0,0,0,0,0,0.0,0.0
192,GAIS-Net,4,11,7,12,15,19,46.053747805010275,74.23092131656186,2.1818181818181817,161.9583737815895,8.997687432310528,0.024743640438853954
193,GAIS-Net,1,1,1,1,2,2,0.0,2.0,0.5,1.0,0.05555555555555555,0.0006666666666666666
194,GAIS-Net,0,0,0,0,0,0,0,0,0,0,0.0,0.0
195,GAIS-Net,8,21,12,22,29,34,116.23866587835397,165.17135383433748,4.190476190476191,692.1466255915095,38.452590310639415,0.05505711794477916
196,GAIS-Net,7,18,18,28,25,46,94.71013448036484,213.6173847296373,5.444444444444445,1163.0279835280253,64.61266575155696,0.0712057949098791
197,GAIS-Net,4,9,7,12,13,19,36.52932501298081,70.30835464468075,2.6666666666666665,187.48894571914866,10.416052539952704,0.02343611821489358
198,GAIS-Net,4,8,7,11,12,18,32.0,64.52932501298082,2.75,177.45564378569725,9.85864687698318,0.02150977500432694
199,GAIS-Net,9,41,27,53,50,80,248.18895720232226,451.50849518197793,5.817073170731708,2626.4579536805304,145.91433076002946,0.15050283172732598
200,GAIS-Net,0,0,0,0,0,0,0,0,0,0,0.0,0.0
201,GAIS-Net,0,0,0,0,0,0,0,0,0,0,0.0,0.0
202,GAIS-Net,8,31,19,36,39,55,177.58008562199316,290.6971220374237,4.645161290322581,1350.33501849642,75.01861213869,0.09689904067914124
203,GAIS-Net,7,39,26,50,46,76,225.78217099003092,419.790708660333,4.487179487179487,1883.6762568091865,104.64868093384369,0.139930236220111
204,GAIS-Net,10,59,51,95,69,146,380.2952208612223,891.8445706896129,8.05084745762712,7180.10459453502,398.89469969639,0.2972815235632043
205,GAIS-Net,2,4,5,9,6,14,10.0,36.18947501009619,2.25,81.42631877271643,4.523684376262024,0.012063158336698729
206,GAIS-Net,6,21,14,27,27,41,107.74844088268091,194.95038758870223,3.857142857142857,751.9514949849943,41.775083054721904,0.06498346252956741
207,GAIS-Net,4,17,10,17,21,27,77.48686830125578,118.59257041502654,2.0,237.1851408300531,13.176952268336283,0.03953085680500885
208,GAIS-Net,2,4,3,5,6,8,10.0,20.67970000576925,1.25,25.84962500721156,1.43609027817842,0.006893233335256416
209,GAIS-Net,0,0,0,0,0,0,0,0,0,0,0.0,0.0
210,GAIS-Net,6,18,11,22,24,33,90.56842503028855,151.30376252379818,3.6666666666666665,554.78046258726,30.82113681040333,0.05043458750793273
211,GAIS-Net,9,105,76,147,114,223,733.5251043679237,1523.7344731587375,6.3,9599.527180900046,533.3070656055581,0.5079114910529124
212,GAIS-Net,0,0,0,0,0,0,0,0,0,0,0.0,0.0
213,GAIS-Net,0,0,0,0,0,0,0,0,0,0,0.0,0.0
214,GAIS-Net,1,1,1,1,2,2,0.0,2.0,0.5,1.0,0.05555555555555555,0.0006666666666666666
215,GAIS-Net,0,0,0,0,0,0,0,0,0,0,0.0,0.0
216,GAIS-Net,10,36,22,40,46,62,219.33658100079685,342.4608412755348,5.555555555555555,1902.5602293085265,105.69779051714036,0.1141536137585116
217,GAIS-Net,9,29,17,33,38,50,169.41077387168042,262.39637567217926,5.120689655172414,1343.6504064592627,74.64724480329238,0.08746545855739309
218,GAIS-Net,2,4,2,4,6,6,10.0,15.509775004326936,1.0,15.509775004326936,0.861654166907052,0.005169925001442312
219,GAIS-Net,4,7,16,19,11,35,27.651484454403228,121.08010665230542,5.428571428571429,657.2920075410866,36.51622264117148,0.040360035550768475
220,GAIS-Net,2,10,8,16,12,24,35.219280948873624,86.03910001730776,1.6,137.66256002769242,7.647920001538468,0.028679700005769252
221,GAIS-Net,0,0,0,0,0,0,0,0,0,0,0.0,0.0
222,GAIS-Net,12,34,30,58,46,88,215.99328661116544,486.07345213301716,10.235294117647058,4975.104745361469,276.3947080756372,0.16202448404433906
223,GAIS-Net,9,30,21,42,39,63,175.7360428812364,332.98033978832166,6.3,2097.7761406664263,116.54311892591257,0.11099344659610721
224,GAIS-Net,19,171,136,257,190,393,1349.1634028009169,2974.9532540740624,14.277777777777779,42475.72146094634,2359.7623033859077,0.9916510846913541
225,GAIS-Net,4,41,34,65,45,99,227.65963218934144,543.6934565366378,3.1707317073170733,1723.9060817015345,95.7725600945297,0.18123115217887925
226,GAIS-Net,10,37,29,51,47,80,225.9690554771448,444.367108134211,6.891891891891892,3062.5300695736164,170.14055942075646,0.14812236937807033
227,GAIS-Net,0,0,0,0,0,0,0,0,0,0,0.0,0.0
228,GAIS-Net,0,0,0,0,0,0,0,0,0,0,0.0,0.0
229,GAIS-Net,10,21,11,21,31,32,125.4579468272276,158.53428193238003,5.0,792.6714096619002,44.03730053677223,0.05284476064412667
230,GAIS-Net,2,5,3,6,7,9,13.60964047443681,25.26619429851844,1.2,30.319433158222125,1.6844129532345624,0.008422064766172813
231,GAIS-Net,12,27,16,29,39,45,171.40151256706756,237.8430998488012,6.444444444444445,1532.7666434700523,85.1537024150029,0.07928103328293373
232,GAIS-Net,0,0,0,0,0,0,0,0,0,0,0.0,0.0
233,GAIS-Net,1,2,1,2,3,3,2.0,4.754887502163469,0.5,2.3774437510817346,0.1320802083934297,0.0015849625007211565
234,GAIS-Net,6,19,10,19,25,29,96.22039775975506,134.671829503467,3.0,404.015488510401,22.4453049172445,0.044890609834489
235,GAIS-Net,1,2,1,2,3,3,2.0,4.754887502163469,0.5,2.3774437510817346,0.1320802083934297,0.0015849625007211565
236,GAIS-Net,0,0,0,0,0,0,0,0,0,0,0.0,0.0
237,GAIS-Net,18,74,66,120,92,186,534.558199082504,1213.3825238266045,14.594594594594595,17708.82602341531,983.8236679675172,0.40446084127553483
238,GAIS-Net,0,0,0,0,0,0,0,0,0,0,0.0,0.0
239,GAIS-Net,13,55,43,78,68,121,366.08050057969047,736.5830037912912,9.218181818181819,6789.95605313063,377.21978072947945,0.24552766793043038
240,GAIS-Net,0,0,0,0,0,0,0,0,0,0,0.0,0.0
241,GAIS-Net,11,29,25,49,40,74,178.93519666370986,393.82267902166484,9.293103448275861,3659.834896425471,203.32416091252617,0.13127422634055494
242,GAIS-Net,0,0,0,0,0,0,0,0,0,0,0.0,0.0
243,GAIS-Net,11,32,27,53,43,80,198.0537478050103,434.1011803761678,9.109375,3954.3904399891535,219.68835777717518,0.1447003934587226
244,GAIS-Net,0,0,0,0,0,0,0,0,0,0,0.0,0.0
245,GAIS-Net,5,13,8,13,18,21,59.715356810271004,87.56842503028855,2.5,218.92106257572138,12.162281254206743,0.029189475010096184
246,GAIS-Net,7,18,13,24,25,37,94.71013448036484,171.8226790216648,4.666666666666667,801.8391687677691,44.54662048709829,0.057274226340554936
247,GAIS-Net,3,3,3,6,6,9,9.509775004326938,23.264662506490403,3.0,69.79398751947122,3.877443751081734,0.007754887502163467
248,GAIS-Net,0,0,0,0,0,0,0,0,0,0,0.0,0.0
249,GAIS-Net,6,13,10,16,19,26,63.61549134016113,110.44611534953322,3.6923076923076925,407.8010412905842,22.655613405032454,0.03681537178317774
250,GAIS-Net,9,27,20,39,36,59,156.9112875713945,305.0255750850964,6.5,1982.6662380531268,110.14812433628482,0.10167519169503214
